Ireland, W. H. (William Henry)	Ireland, W. H	Ireland, W. H. (William Henry)
Ireland, Annie Elizabeth (Nicholson)	Ireland, Annie Elizabeth Nicholson	Ireland, Annie Elizabeth (Nicholson)
Pemberton, Max, Sir	Pemberton, Max	Pemberton, Max, Sir
Peterson, Charles J. (Charles Jacobs)	Peterson, Charles J (Charles Jacobs)	Peterson, Charles J. (Charles Jacobs)
Perry, B. F. (Benjamin Franklin)	Perry, B. F. (Benjamin Franklin)	Perry, B. F
Pearce, J. H. (Joseph Henry)	Pearce, J. H. (Joseph Henry)	Pearce, J. H
Pennell, Elizabeth (Robins)	Pennell, Elizabeth (Robins)	Pennell, Elizabeth Robins
Pearson, Paul M. (Paul Martin)	Pearson, Paul M. (Paul Martin)	Pearson, Paul M
Pearson, C. H. (Charles Henry)	Pearson, C. H	Pearson, C. H. (Charles Henry)
Peattie, Louise Redfield, Mrs	Peattie, Louise Redfield, Mrs	Peattie, Louise Redfield
Pearson, Emily Clemens	Pearson, Emily Clemens	Pearson, Emily Clemens]
Peck, George W. (George Wilbur)	Peck, George W. (George Wilbur)	Peck, George W (George Wilbur)	Peck, George W
Pearson, T. Gilbert (Thomas Gilbert)	Pearson, T. Gilbert (Thomas Gilbert)	Pearson, T. Gilbert
Pedler, Margaret (Bass), Mrs	Pedler, Margaret (Bass)	Pedler, Margaret (Bass), Mrs
Peirce, B. K. (Bradford Kinney)	Peirce, B. K	Peirce, B. K. (Bradford Kinney)
Perkins, Edna Brush, Mrs	Perkins, Edna Brush	Perkins, Edna Brush, Mrs
Pepys, Charlotte Maria, Lady	Pepys, Charlotte Maria, Lady	Pepys, Charlotte Maria
Ognev, N. (Nikolaĭ)	Ognev, N. (Nikolaĭ)	Ognev, N (Nikolaĭ)	Ognev, N (Nikolaĭ)	Ognev, N. (Nikolaĭ)
Evans, Augusta J. (Augusta Jane)	Evans, Augusta J	Evans, Augusta J. (Augusta Jane)	Evans, Augusta J (Augusta Jane)
Evans, Florence (Wilkinson), Mrs	Evans, Florence (Wilkinson)	Evans, Florence Wilkinson	Evans, Florence (Wilkinson), Mrs
Evarts, Hal G. (Hal George)	Evarts, Hal G. (Hal George)	Evarts, Hal G
Evans, Della J.	Evans, Della J. [from old catalog]	Evans, Della J
Evans, Marguerite Florence H??l??ne Jervis	Evans, Marguerite Florence Jervis Barclay	Evans, Marguerite Florence H??l??ne Jervis	Evans, Marguerite Florence Jervis
Zeyneb, hanum	Zeyneb, hanum	Zeyneb, Hanum
Ewing, Juliana Horatia Gatty	Ewing, Juliana Horatia Gatty	Ewing, Juliana Horatia
Neale, W. Johnson (William Johnson)	Neale, W. Johnson (William Johnson)	Neale, W. Johnson
Neal, Joseph C. (Joseph Clay)	Neal, Joseph C. (Joseph Clay)	Neal, Joseph C
Nesbit, E. (Edith)	Nesbit, E (Edith)	Nesbit, E	Nesbit, E. (Edith)
Newell, C. M. (Charles Martin)	Newell, C. M. (Charles Martin)	Newell, C. M (Charles Martin)
Neverov, A. S. (Aleksandr Sergeevich)	Neverov, A. S (Aleksandr Sergeevich)	Neverov, A. S. (Aleksandr Sergeevich)
Newbolt, Henry John, Sir	Newbolt, Henry John, Sir	Newbolt, Henry John
Needell, J. H, Mrs	Needell, J. H	Needell, J. H, Mrs
Nemirovich-Danchenko, Vasili?_ Ivanovich	Nemirovich-Danchenko, Vasili?_ Ivanovich	Nemirovich-Danchenko, Vasiliĭ Ivanovich	Nemirovich-Danchenko, Vasiliĩ Ivanovich
Newell, R. H. (Robert Henry)	Newell, R. H. (Robert Henry)	Newell, R. H
Newby, P. H. (Percy Howard)	Newby, P. H (Percy Howard)	Newby, P. H. (Percy Howard)
Newton, W. Douglas, (Wilfrid Douglas)	Newton, W. Douglas (Wilfrid Douglas)	Newton, W. Douglas, (Wilfrid Douglas)
Neale, J. M. (John Mason)	Neale, J. M (John Mason)	Neale, J. M. (John Mason)
Neely, Henry M. (Henry Milton)	Neely, Henry M. (Henry Milton)	Neely, Henry M
Putnam Weale, B. L. (Bertram Lenox)	Putnam Weale, B. L	Putnam Weale, B. L. (Bertram Lenox)
Putnam, Nina (Wilcox), Mrs	Putnam, Nina (Wilcox), Mrs	Putnam, Nina Wilcox	Putnam, Nina (Wilcox)
Pullen, H. W. (Henry William)	Pullen, H. W	Pullen, H. W. (Henry William)
Herbert, A. P. Sir, (Alan Patrick)	Herbert, A. P (Alan Patrick)	Herbert, A. P. Sir, (Alan Patrick)	Herbert, A. P	Herbert, A. P. (Alan Patrick)	Herbert, A. P. (Alan Patrick), Sir
Helps, Arthur, Sir	Helps, Arthur	Helps, Arthur, Sir
Hermann, I. (Isaac)	Hermann, I	Hermann, I. (Isaac)
Heath, W. L. (William L.)	Heath, W. L. (William L.)	Heath, W. L (William L.)
Henry, Alfred H. (Alfred Hylas)	Henry, Alfred H. (Alfred Hylas)	Henry, Alfred H
Henty, G. A. (George Alfred)	Henty, G. A. (George Alfred)	Henty, G. A (George Alfred)	Henty, G. A	Henty, G.A. (George Alfred)
Henriques, Robert David, Quixano	Henriques, Robert David Quixano	Henriques, Robert David, Quixano
Hegermann-Lindencrone, L. de (Lillie de)	Hegermann-Lindencrone, L. de	Hegermann-Lindencrone, L. de (Lillie de)
Head, George, Sir	Head, George, Sir	Head, George
Herring, J. L. (John Lewis)	Herring, J. L	Herring, J. L. (John Lewis)
Head, Francis Bond, Sir	Head, Francis Bond	Head, Francis Bond, Sir
Henderson, W. J. (William James)	Henderson, W. J	Henderson, W. J. (William James)
Henderson, B. L. K. (Bernard Lionel Kinghorn)	Henderson, B. L. K	Henderson, B. L. K. (Bernard Lionel Kinghorn)
Hewlett, J. (Joseph)	Hewlett, J	Hewlett, J. (Joseph)
Heinlein, Robert A. (Robert Anson)	Heinlein, Robert A (Robert Anson)	Heinlein, Robert A. (Robert Anson)
Heaton, Eliza Osborn (Putnam), Mrs	Heaton, Eliza Osborn (Putnam), Mrs	Heaton, Eliza Osborn (Putnam)
Meek, S. P. (Sterner St. Paul)	Meek, S. P	Meek, S. P. (Sterner St. Paul)
Mencken, H. L. (Henry Louis)	Mencken, H. L. (Henry Louis)	Mencken, H. L
Meyer, John J. (John Joseph)	Meyer, John J (John Joseph)	Meyer, John J. (John Joseph)
Mechling, W        H.	Mechling, W. H	Mechling, W        H
Merwin, W. S. (William Stanley)	Merwin, W. S. (William Stanley)	Merwin, W. S (William Stanley)
Mehdevi, Anne (Sinclair)	Mehdevi, Anne (Sinclair)	Mehdevi, Anne Sinclair
Kyne, Peter B. (Peter Bernard)	Kyne, Peter B	Kyne, Peter B. (Peter Bernard)
Aswell, Mary Louise (White)	Aswell, Mary Louise (White)	Aswell, Mary Louise White
Quincy, Samuel M. (Samuel Miller)	Quincy, Samuel M. (Samuel Miller)	Quincy, Samuel M
Quiller-Couch, Arthur Thomas, Sir	Quiller-Couch, Arthur Thomas, Sir	Quiller-Couch, Arthur Thomas	Quiller-Couch, Arthur
Boston, L. M. (Lucy Maria)	Boston, L. M (Lucy Maria)	Boston, L. M. (Lucy Maria)
Boyns, R. E. (Richard Edward)	Boyns, R. E. (Richard Edward)	Boyns, R. E
Bone, David W. (David William)	Bone, David W	Bone, David W. (David William)
Bourhill, E. J, Mrs	Bourhill, E. J	Bourhill, E. J, Mrs
Bodkin, M. McDonnell (Matthias McDonnell)	Bodkin, M. McDonnell (Matthias McDonnell)	Bodkin, M. McDonnell	Bodkin, M. McD. (Matthias McDonnell)
Boyle, Virginia (Frazer), Mrs	Boyle, Virginia (Frazer), Mrs	Boyle, Virginia (Frazer)	Boyle, Virginia Frazer
Bower, B. M, Mrs	Bower, B. M	Bower, B. M, Mrs
Bolton, Sarah (Knowles)	Bolton, Sarah Knowles	Bolton, Sarah (Knowles)
Borgman, C. F. (Charles F.)	Borgman, C. F (Charles F.)	Borgman, C. F. (Charles F.)
Booth, Edward C. (Edward Charles)	Booth, Edward C	Booth, Edward C. (Edward Charles)
Botsford, Charles A. (Charles Alexander)	Botsford, Charles A. (Charles Alexander)	Botsford, Charles A
Champney, Elizabeth W. (Elizabeth Williams)	Champney, Elizabeth Williams	Champney, Elizabeth (Williams), Mrs	Champney, Elizabeth (Williams)	Champney, Elizabeth W. (Elizabeth Williams)	Champney, Elizabeth W
Chappell, George S. (George Shepard)	Chappell, George S. (George Shepard)	Chappell, George S
Chambers, Robert W. (Robert William)	Chambers, Robert W	Chambers, Robert W. (Robert William)
Chase, Eliza B. (Eliza Brown)	Chase, Eliza B	Chase, Eliza B. (Eliza Brown)
Christensen, Lars Saaybe	Christensen, Lars Saaybe	Christensen, Lars Saabye
Chetwood, W. R. (William Rufus)	Chetwood, W. R	Chetwood, W. R. (William Rufus)	Chetwood, W. R (William Rufus)
Churchill, Winston, Sir	Churchill, Winston, Sir	Churchill, Winston
Chase, J. Smeaton (Joseph Smeaton)	Chase, J. Smeaton (Joseph Smeaton)	Chase, J. Smeaton
Chase, Margaret Hatfield, Mrs	Chase, Margaret Hatfield	Chase, Margaret Hatfield, Mrs
Chesterton, G. K. (Gilbert Keith)	Chesterton, G. K (Gilbert Keith)	Chesterton, G. K. (Gilbert Keith)	Chesterton, G. K
Cheley, F. H. (Frank Hobart)	Cheley, F. H. (Frank Hobart)	Cheley, F. H
Challice, Annie Emma (Armstrong), Mrs	Challice, Annie Emma (Armstrong)	Challice, Annie Emma (Armstrong), Mrs
Chisholm, A. M. (Arthur Murray)	Chisholm, A. M. (Arthur Murray)	Chisholm, A. M
Child, (Lydia Maria), Mrs	Child, Lydia Maria	Child, (Lydia Maria), Mrs
Chamberlain, N. H. (Nathan Henry)	Chamberlain, N. H	Chamberlain, N. H. (Nathan Henry)
Chatterton, Georgiana, Lady	Chatterton, Georgiana	Chatterton, Georgiana, Lady
Channon, E. M. (Ethel Mary)	Channon, E. M	Channon, E. M. (Ethel Mary)
Chase, Amanda (Mathews), Mrs	Chase, Amanda (Mathews), Mrs	Chase, Amanda (Mathews)
Chesnutt, Charles W. (Charles Waddell)	Chesnutt, Charles W	Chesnutt, Charles W. (Charles Waddell)	Chesnutt, Charles W (Charles Waddell)
Chesney, George Tomkyns, Sir	Chesney, George Tomkyns, Sir	Chesney, George Tomkyns
Chatfield-Taylor, H. C. (Hobart Chatfield)	Chatfield-Taylor, H. C. (Hobart Chatfield)	Chatfield-Taylor, H. C
Chamot, A. E. (Alfred Edward)	Chamot, A. E. (Alfred Edward)	Chamot, A. E (Alfred Edward)
Eells, Elsie (Spicer) Mrs	Eells, Elsie (Spicer) Mrs	Eells, Elsie Spicer
McGary, Elizabeth Vis??re	McGary, Elizabeth Vis??re	McGary, Elizabeth Visère	McGary, Elizabeth Vis??re. [from old catalog]
McDonald, Etta Austin (Blaisdell), Mrs	McDonald, Etta Austin (Blaisdell)	McDonald, Etta Austin Blaisdell	McDonald, Etta Austin (Blaisdell), Mrs
McCarthy, Justin H , (Justin Huntly)	McCarthy, Justin H , (Justin Huntly)	McCarthy, Justin H	McCarthy, Justin H. (Justin Huntly)
McCutcheon, John T. (John Tinney)	McCutcheon, John T. (John Tinney)	McCutcheon, John T
McIntosh, Maria J. (Maria Jane)	McIntosh, Maria J. (Maria Jane)	McIntosh, Maria J
McNaught, Rosamond (Livingstone), Mrs	McNaught, Rosamond (Livingstone)	McNaught, Rosamond Livingstone	McNaught, Rosamond (Livingstone), Mrs
McLaren, Jack, Mrs	McLaren, Jack, Mrs	McLaren, Jack
McNeile, H. C. (Herman Cyril)	McNeile, H. C	McNeile, H. C. (Herman Cyril)
McNeal, T. A. (Thomas Allen)	McNeal, T. A. (Thomas Allen)	McNeal, T. A
McSpadden, J. Walker (Joseph Walker)	McSpadden, J. Walker (Joseph Walker)	McSpadden, J. Walker
McClure, J. B. (James Baird)	McClure, J. B. (James Baird)	McClure, J. B
McKeown, Martha (Ferguson)	McKeown, Martha Ferguson	McKeown, Martha (Ferguson)
McKeever, Harriet B. (Harriet Burn)	McKeever, Harriet B. (Harriet Burn)	McKeever, Harriet B
Libedinskiĭ, I͡U. (I͡Uriĭ)	Libedinskiĭ, I͡U (I͡Uriĭ)	Libedinskiĭ, I͡U. (I͡Uriĭ)
Lighton, William R. (William Rheem)	Lighton, William R. (William Rheem)	Lighton, William R
Livingstone, W. P. (William Pringle)	Livingstone, W. P	Livingstone, W. P. (William Pringle)
Linton, E. Lynn (Elizabeth Lynn)	Linton, E. Lynn	Linton, E. Lynn (Elizabeth Lynn)
Lipsett,  H. Caldwell	Lipsett,  H. Caldwell	Lipsett, H. Caldwell
Linevskiĭ, A. (Aleksandr)	Linevskiĭ, A. (Aleksandr)	Linevskiĭ, A (Aleksandr)
Rølvaag, O. E. (Ole Edvart)	Rølvaag, O. E. (Ole Edvart)	Rølvaag, O. E (Ole Edvart)
Cobb, James F. (James Francis)	Cobb, James F	Cobb, James F. (James Francis)
Costello, F. H. (Frederick Hankerson)	Costello, F. H	Costello, F. H. (Frederick Hankerson)
Coppard, A. E. (Alfred Edgar)	Coppard, A. E (Alfred Edgar)	Coppard, A. E	Coppard, A. E. (Alfred Edgar)
Costain, Thomas B. (Thomas Bertram)	Costain, Thomas B. (Thomas Bertram)	Costain, Thomas B (Thomas Bertram)
Cory, David (David Magie)	Cory, David Magie	Cory, David (David Magie)
Comstock, Harriet T. (Harriet Theresa)	Comstock, Harriet T	Comstock, Harriet T. (Harriet Theresa)
Cobb, Irvin S. (Irvin Shrewsbury)	Cobb, Irvin S. (Irvin Shrewsbury)	Cobb, Irvin S (Irvin Shrewsbury)	Cobb, Irvin S
Conkling, Margaret C. (Margaret Cockburn)	Conkling, Margaret C. (Margaret Cockburn)	Conkling, Margaret C
Cottrell, Dorothy Wilkinson, Mrs	Cottrell, Dorothy Wilkinson, Mrs	Cottrell, Dorothy (Wilkinson)	Cottrell, Dorothy Wilkinson
Coulton, G. G. (George Gordon)	Coulton, G. G	Coulton, G. G. (George Gordon)
Cooper, E. H. (Edward Herbert)	Cooper, E. H	Cooper, E. H. (Edward Herbert)
Cobban, J. Maclaren (James Maclaren)	Cobban, J. Maclaren	Cobban, J. Maclaren (James Maclaren)
Cornford, L. Cope (Leslie Cope)	Cornford, L. Cope	Cornford, L. Cope (Leslie Cope)
Connolly, James B. (James Brendan)	Connolly, James B	Connolly, James B. (James Brendan)	Connolly, James B (James Brendan)
Colmore, G. (Gertrude)	Colmore, G	Colmore, G. (Gertrude)
Collingwood, Herbert W. (Herbert Winslow)	Collingwood, Herbert W. (Herbert Winslow)	Collingwood, Herbert W
Cory, Charles B. (Charles Barney)	Cory, Charles B	Cory, Charles B. (Charles Barney)
Countess of, Munster, Wilhelmina Kennedy-Erskine FitzClarence	Countess of, Munster, Wilhelmina Fitzclarence	Countess of, Munster, Wilhelmina Kennedy-Erskine FitzClarence
Cody, Louisa (Frederici), Mrs	Cody, Louisa (Frederici)	Cody, Louisa (Frederici), Mrs
Coleridge, Mary E. (Mary Elizabeth)	Coleridge, Mary E	Coleridge, Mary E. (Mary Elizabeth)
Cox, George W. (George William)	Cox, George W. (George William)	Cox, George W	Cox, George W (George William)
Cooley, Alice (Kingsbury)	Cooley, Alice (Kingsbury)	Cooley, Alice Kingsbury
Covey, Elizabeth Rockford, Mrs	Covey, Elizabeth (Rockford)	Covey, Elizabeth Rockford, Mrs
Compton-Burnett, I. (Ivy)	Compton-Burnett, I. (Ivy)	Compton-Burnett, I (Ivy)
Cowles, Julia (Darrow), Mrs	Cowles, Julia Darrow	Cowles, Julia (Darrow), Mrs
Cozzens, Frederic S. (Frederic Swartwout)	Cozzens, Frederic S	Cozzens, Frederic S. (Frederic Swartwout)
Colman, (Pamela Chandler), Mrs	Colman, Pamela Chandler	Colman, (Pamela Chandler), Mrs
Coates, Robert M. (Robert Myron)	Coates, Robert M. (Robert Myron)	Coates, Robert M (Robert Myron)
Cody, H. A. (Hiram Alfred)	Cody, H. A	Cody, H. A. (Hiram Alfred)
Codman, Russell, Mrs	Codman, Russell, Mrs	Codman, Russell
Coursey, O. W. (Oscar William)	Coursey, O. W (Oscar William)	Coursey, O. W. (Oscar William)
Naipaul, V. S. (Vidiadhar Surajprasad)	Naipaul, V. S (Vidiadhar Surajprasad)	Naipaul, V. S. (Vidiadhar Surajprasad)
Nazhivin, Iv. (Ivan)	Nazhivin, Iv (Ivan)	Nazhivin, Iv. (Ivan)
Naylor, J. B. (James Ball)	Naylor, J. B	Naylor, J. B. (James Ball)
Bennett, W. H (William Henry)	Bennett, W. H (William Henry)	Bennett, W. H
Bezzerides, A. I. (Albert Isaac)	Bezzerides, A. I (Albert Isaac)	Bezzerides, A. I. (Albert Isaac)
Benson, B. K. (Blackwood Ketcham)	Benson, B. K. (Blackwood Ketcham)	Benson, B. K
Bentley, E. C. (Edmund Clerihew)	Bentley, E. C. (Edmund Clerihew)	Bentley, E. C (Edmund Clerihew)
Belisle, D. W. (David W.)	Belisle, D. W	Belisle, D. W. (David W.)
Bell, J. J. (John Joy)	Bell, J. J	Bell, J. J. (John Joy)
Benson, E. F. (Edward Frederick)	Benson, E. F. (Edward Frederick)	Benson, E.F. (Edward Frederic)	Benson, E. F	Benson, E. F. (Edward Frederic)	Benson, E. F (Edward Frederic)
Beresford, J. D. (John Davys)	Beresford, J. D. (John Davys)	Beresford, J. D
Berlin, Ellin MacKay	Berlin, Ellin MacKay	Berlin, Ellin Mackay
Bedford-Jones, H. (Henry)	Bedford-Jones, H	Bedford-Jones, H. (Henry)
Belcher, Edward, Sir	Belcher, Edward, Sir	Belcher, Edward
Beck, L. Adams (Lily Adams)	Beck, L. Adams (Lily Adams)	Beck, L. Adams
Berkeley, Grantley F. (Grantley Fitzhardinge)	Berkeley, Grantley F. (Grantley Fitzhardinge)	Berkeley, Grantley F
Bell, F. McKelvey (Frederick McKelvey)	Bell, F. McKelvey	Bell, F. McKelvey (Frederick McKelvey)
Beerbohm, Max, Sir	Beerbohm, Max	Beerbohm, Max, Sir
Beecher, Henry Ward, Mrs	Beecher, Henry Ward, Mrs	Beecher, Henry Ward
Benecke, Else C. M. (Else Cecilia Mendelssohn)	Benecke, Else C. M	Benecke, Else C. M. (Else Cecilia Mendelssohn)
Bechdolt, Frederick R. (Frederick Ritchie)	Bechdolt, Frederick R	Bechdolt, Frederick R. (Frederick Ritchie)
Beebe, Iola, Mrs	Beebe, Iola, Mrs	Beebe, Iola
Besant, Walter, Sir	Besant, Walter	Besant, Walter, Sir
Jacobs, W. W. (William Wymark)	Jacobs, W. W. (William Wymark)	Jacobs, W. W (William Wymark)	Jacobs, W. W	Jacobs, W.W
James, G. P. R. (George Payne Rainsford)	James, G. P. R	James, G. P. R. (George Payne Rainsford)
Janvier, Thomas A. (Thomas Allibone)	Janvier, Thomas A. (Thomas Allibone)	Janvier, Thomas A
Jackson, Gabrielle Emilie Snow, Mrs	Jackson, Gabrielle Emilie Snow	Jackson, Gabrielle Emilie Snow, Mrs
Jaques, E. T. (Edward Tyrrell)	Jaques, E. T. (Edward Tyrrell)	Jaques, E. T
James, C. L. R. (Cyril Lionel Robert)	James, C. L. R (Cyril Lionel Robert)	James, C. L. R. (Cyril Lionel Robert)
Jacks, L. P. (Lawrence Pearsall)	Jacks, L. P	Jacks, L. P. (Lawrence Pearsall)
Jagendorf, M. A. (Moritz Adolph)	Jagendorf, M. A (Moritz Adolph)	Jagendorf, M. A. (Moritz Adolph)
Jamison, C. V. (Cecilia Viets)	Jamison, C. V	Jamison, C. V. (Cecilia Viets)
Jacobsen, J. P. (Jens Peter)	Jacobsen, J. P	Jacobsen, J. P. (Jens Peter)	Jacobsen, J. P (Jens Peter)
James, M. R. (Montague Rhodes)	James, M. R. (Montague Rhodes)	James, M. R
Adams, John S. (John Stowell)	Adams, John S	Adams, John S. (John Stowell)
Adams, W. H. Davenport (William Henry Davenport)	Adams, W. H. Davenport (William Henry Davenport)	Adams, W. H. Davenport
Adams, Emma H. (Emma Hildreth)	Adams, Emma H. (Emma Hildreth)	Adams, Emma H
Adams, Frank R. (Frank Ramsay)	Adams, Frank R	Adams, Frank R. (Frank Ramsay)
Guérard, Albert J. (Albert Joseph)	Guérard, Albert J. (Albert Joseph)	Guérard, Albert J (Albert Joseph)
Guthrie, A. B. (Alfred Bertram)	Guthrie, A. B. (Alfred Bertram)	Guthrie, A. B (Alfred Bertram)
Guest, Edgar A. (Edgar Albert)	Guest, Edgar A. (Edgar Albert)	Guest, Edgar A	Guest, Edgar A (Edgar Albert)
Gusev-Orenburgskiĭ, S. I. (Sergeĭ Ivanovich)	Gusev-Orenburgskiĭ, S. I. (Sergeĭ Ivanovich)	Gusev-Orenburgskiĭ, S. I (Sergeĭ Ivanovich)
Gunning, Mrs. (Susannah)	Gunning, Mrs. (Susannah)	Gunning, (Susannah), Mrs
Guerber, H. A. (Hélène Adeline)	Guerber, H. A	Guerber, H. A. (Hélène Adeline)
Gurney, A. R. (Albert Ramsdell)	Gurney, A. R (Albert Ramsdell)	Gurney, A. R. (Albert Ramsdell)
Campbell, Juliet H. L. (Juliet Hamersley Lewis)	Campbell, Juliet H. L. (Juliet Hamersley Lewis)	Campbell, Juliet H. L
Cain, James M. (James Mallahan)	Cain, James M. (James Mallahan)	Cain, James M (James Mallahan)
Calkins, Frank W. (Frank Welles)	Calkins, Frank W	Calkins, Frank W. (Frank Welles)
Caffyn, Kathleen Mannington (Hunt)	Caffyn, Kathleen Mannington (Hunt)	Caffyn, Kathleen Mannington Hunt
Carr, J. L. (Joseph Lloyd)	Carr, J. L. (Joseph Lloyd)	Carr, J. L. (James Lloyd)
Castle, William R. (William Richards)	Castle, William R	Castle, William R. (William Richards)
Carlsen, C. L. (Carl Laurence)	Carlsen, C. L. (Carl Laurence)	Carlsen, C. L
Castle, Agnes (Sweetman), Mrs	Castle, Agnes (Sweetman)	Castle, Agnes (Sweetman), Mrs
Carter, William H (William Harding)	Carter, William H	Carter, William H (William Harding)
Campbell, J. F. (John Francis)	Campbell, J. F	Campbell, J. F. (John Francis)
Cabrera Infante, G. (Guillermo)	Cabrera Infante, G. (Guillermo)	Cabrera Infante, G (Guillermo)
Caine, Hall, Sir	Caine, Hall	Caine, Hall, Sir
Cassill, R. V. (Ronald Verlin)	Cassill, R. V (Ronald Verlin)	Cassill, R. V. (Ronald Verlin)
Campbell, C. G. (Charles Grimshaw)	Campbell, C. G (Charles Grimshaw)	Campbell, C. G. (Charles Grimshaw)
Umbstaetter, H. D. (Herman Daniel)	Umbstaetter, H. D. (Herman Daniel)	Umbstaetter, H. D
Hsiung, S. I. (Shih I)	Hsiung, S. I. (Shih I)	Hsiung, S. I (Shih I)
Lucas, E. V. (Edward Verrall)	Lucas, E. V	Lucas, E. V. (Edward Verrall)
Luke, Jemima (Thompson)	Luke, Jemima Thompson	Luke, Jemima (Thompson)
Webber, Charles W. (Charles Wilkins)	Webber, Charles W	Webber, Charles W. (Charles Wilkins)	Webber, Charles W (Charles Wilkins)
Westervelt, W. D (William Drake)	Westervelt, W. D (William Drake)	Westervelt, W. D
Weiskopf, F. C. (Franz Carl)	Weiskopf, F. C. (Franz Carl)	Weiskopf, F. C (Franz Carl)
Wellman, Paul I. (Paul Iselin)	Wellman, Paul I. (Paul Iselin)	Wellman, Paul I (Paul Iselin)
Weir, Florence (Roney), Mrs	Weir, Florence (Roney)	Weir, Florence Roney	Weir, Florence (Roney), Mrs
Weaver, John V. A. (John Van Alstyne)	Weaver, John V. A. (John Van Alstyne)	Weaver, John V. A
Wedmore, Frederick, Sir	Wedmore, Frederick, Sir	Wedmore, Frederick
West, (Jane), Mrs	West, (Jane), Mrs	West, Jane
Welles, Harriet Ogden (Deen), Mrs	Welles, Harriet Ogden (Deen), Mrs	Welles, Harriet Ogden (Deen)
Wells, H. G. (Herbert George)	Wells, H. G	Wells, H. G (Herbert George)	Wells, H. G. (Herbert George)
Wetmore, Claude H. (Claude Hazeltine)	Wetmore, Claude H (Claude Hazeltine)	Wetmore, Claude H. (Claude Hazeltine)
Weld, H. Hastings (Horatio Hastings)	Weld, H. Hastings	Weld, H. Hastings (Horatio Hastings)
Richards, Jarrett T. (Jarrett Thomas)	Richards, Jarrett T. (Jarrett Thomas)	Richards, Jarrett T
Richardson, Charles F. (Charles Francis)	Richardson, Charles F. (Charles Francis)	Richardson, Charles F
Richardson, Dorothy M. (Dorothy Miller)	Richardson, Dorothy M (Dorothy Miller)	Richardson, Dorothy M. (Dorothy Miller)	Richardson, Dorothy Miller	Richardson, Dorothy M
Riis, Jacob A. (Jacob August)	Riis, Jacob A (Jacob August)	Riis, Jacob A. (Jacob August)	Riis, Jacob A
Richardson, Henry Handel, pseud	Richardson, Henry Handel, pseud	Richardson, Henry Handel
Richmond, Grace S. (Grace Smith)	Richmond, Grace S	Richmond, Grace S. (Grace Smith)
Rives, Judith Page (Walker)	Rives, Judith Page (Walker)	Rives, Judith Page Walker
Riddell, J. H., Mrs	Riddell, J. H., Mrs	Riddell, J. H, Mrs	Riddell, J. H
Ridge, W. Pett (William Pett)	Ridge, W. Pett	Ridge, W. Pett (William Pett)
Richmond, Grace Louise (Smith), Mrs	Richmond, Grace Louise (Smith) Mrs	Richmond, Grace Louise (Smith), Mrs
Rivers, George R. R. (George Robert Russell)	Rivers, George R. R	Rivers, George R. R. (George Robert Russell)
Rice, Edward I. (Edward Irving)	Rice, Edward I. (Edward Irving)	Rice, Edward I
Sedgwick, Susan Anne Livingston (Ridley)	Sedgwick, Susan Anne Livingston (Ridley)	Sedgwick, Susan Anne Livingston Ridley
Seymour, St. John D. (St. John Drelincourt)	Seymour, St. John D. (St. John Drelincourt)	Seymour, St. John D	Seymour, St. John D (St. John Drelincourt)
Seaman, Owen, Sir	Seaman, Owen, Sir	Seaman, Owen
Service, Robert W. (Robert William)	Service, Robert W. (Robert William)	Service, Robert W (Robert William)
Seymour, Beatrice Kean (Stapleton), Mrs	Seymour, Beatrice Kean (Stapleton), Mrs	Seymour, Beatrice Kean
Owen, H. Collinson (Harry Collinson)	Owen, H. Collinson (Harry Collinson)	Owen, H. Collinson
Fénelon, François de Salignac de La Mothe-	Fénelon, François de Salignac de La Mothe-	Fénelon, François de Salignac de la Mothe
Kluge, P. F. (Paul Frederick)	Kluge, P. F. (Paul Frederick)	Kluge, P. F (Paul Frederick)
Klette, C. H. B. (Charles Herman Bruno)	Klette, C. H. B. (Charles Herman Bruno)	Klette, C. H. B
Hichens, Robert (Robert Smythe)	Hichens, Robert (Robert Smythe)	Hichens, Robert Smythe
Hilton, Harold H. (Harold Horsfall)	Hilton, Harold H	Hilton, Harold H. (Harold Horsfall)
Hill, Marion, Mrs	Hill, Marion	Hill, Marion, Mrs
Hill, A. F. (Alonzo F.)	Hill, A. F. (Alonzo F.)	Hill, A. F
Hind, C. Lewis (Charles Lewis)	Hind, C. Lewis (Charles Lewis)	Hind, C. Lewis
Oppenheim, E. Phillips (Edward Phillips)	Oppenheim, E. Phillips	Oppenheim, E. Phillips (Edward Phillips)
Avena, M  R    (Mauro Ragasa)	Avena, M  R    (Mauro Ragasa)	Avena, M. R (Mauro R.)
Pyne, W. H. (William Henry)	Pyne, W. H	Pyne, W. H. (William Henry)
Dwight, H. G. (Harrison Griswold)	Dwight, H. G	Dwight, H. G. (Harrison Griswold)
Kennard, Nina H, Mrs	Kennard, Nina H, Mrs	Kennard, Nina H
Keyser, Charles S. (Charles Shearer)	Keyser, Charles S (Charles Shearer)	Keyser, Charles S. (Charles Shearer)
Keane, John F. (John Fryer)	Keane, John F.(John Fryer)	Keane, John F. (John Fryer)
Kendall, Ralph S. (Ralph Selwood)	Kendall, Ralph S	Kendall, Ralph S. (Ralph Selwood)
Kelly, M. A. B. (Meriba Ada Babcock)	Kelly, M. A. B	Kelly, M. A. B. (Meriba Ada Babcock)
Kennedy, Sara Beaumont (Cannon)	Kennedy, Sara Beaumont Cannon	Kennedy, Sara Beaumont (Cannon)
Kennedy, Sidney R. (Sidney Robinson)	Kennedy, Sidney R. (Sidney Robinson)	Kennedy, Sidney R
Ketcham, Wilmot Alexander	Ketcham, Wilmot Alexander	Ketcham,Wilmot Alexander
Aksakov, S. T. (Sergeĭ Timofeevich)	Aksakov, S. T	Aksakov, S. T. (Sergeĭ Timofeevich)	Aksakov, S. T. (Sergeĭ Timofeevich)	Aksakov, S. T (Sergeĭ Timofeevich)
Miller, George Amos, Bishop	Miller, George Amos, bp	Miller, George Amos, Bishop
Miller, Harriet (Mann)	Miller, Harriet (Mann)	Miller, Harriet Mann
Milne, A. A. (Alan Alexander)	Milne, A. A	Milne, A. A. (Alan Alexander)	Milne, A. A (Alan Alexander)
Michener, James A. (James Albert)	Michener, James A. (James Albert)	Michener, James A (James Albert)
Miller, Alice Duer, Mrs	Miller, Alice Duer	Miller, Alice Duer, Mrs
Mitton, G. E. (Geraldine Edith)	Mitton, G. E	Mitton, G. E. (Geraldine Edith)
Minney, R. J. (Rubeigh James)	Minney, R. J. (Rubeigh James)	Minney, R. J	Minney, R. J (Rubeigh James)
Mitchell, Lucy (Sprague)	Mitchell, Lucy Sprague	Mitchell, Lucy (Sprague)
Mihesuah, Devon A. (Devon Abbott)	Mihesuah, Devon A (Devon Abbott)	Mihesuah, Devon A. (Devon Abbott)
Mitchell, William, Sir	Mitchell, William, Sir	Mitchell, William
Mitchell, W. O. (William Ormond)	Mitchell, W. O (William Ormond)	Mitchell, W. O. (William Ormond)
Miln, Louise (Jordan), Mrs	Miln, Louise Jordan	Miln, Louise (Jordan)	Miln, Louise (Jordan), Mrs	Miln, Louise Jordan, Mrs
Mitchell, S. Weir (Silas Weir)	Mitchell, S. Weir	Mitchell, S. Weir (Silas Weir)
Milman, E. A. (Edward Augustus)	Milman, E. A. (Edward Augustus)	Milman, E. A
Miller, D. L, Mrs	Miller, D. L, Mrs	Miller, D. L
Miller, Helen (Topping)	Miller, Helen (Topping)	Miller, Helen Topping
Squire, John Collings, Sir	Squire, John Collings	Squire, John Collings, Sir
Eydoux-D??mians, M.	Eydoux-D??mians, M. [from old catalog]	Eydoux-D??mians, M
Cunningham, H. S. (Henry Stewart), Sir	Cunningham, H. S. (Henry Stewart), Sir	Cunningham, H. S
Cunninghame Graham, R. B. (Robert Bontine)	Cunninghame Graham, R. B	Cunninghame Graham, R. B (Robert Bontine)	Cunninghame Graham, R. B. (Robert Bontine)
Cunningham, J. W. (John William)	Cunningham, J. W	Cunningham, J. W. (John William)
Cummins, Maria S. (Maria Susanna)	Cummins, Maria S	Cummins, Maria S. (Maria Susanna)
Cutting, Mary Stewart Doubleday	Cutting, Mary Stewart	Cutting, Mary Stewart Doubleday
Tolkien, J. R. R. (John Ronald Reuel)	Tolkien, J. R. R (John Ronald Reuel)	Tolkien, J. R. R. (John Ronald Reuel)
Tomlinson, Everett T. (Everett Titsworth)	Tomlinson, Everett T	Tomlinson, Everett T.,$1859-1931	Tomlinson, Everett T. (Everett Titsworth)
Townsend, Edward W. (Edward Waterman)	Townsend, Edward W (Edward Waterman)	Townsend, Edward W. (Edward Waterman)	Townsend, Edward W
Tomlinson, H. M. (Henry Major)	Tomlinson, H. M (Henry Major)	Tomlinson, H. M	Tomlinson, H. M. (Henry Major)
Swettenham, Frank Athelstane, Sir	Swettenham, Frank Athelstane	Swettenham, Frank Athelstane, Sir
Sweetser, Kate Dickinson	Sweetser, Kate Dickinson	Sweetser, Kate Dickinson. [from old catalog]
Swinton, E. D. (Ernest Dunlop)	Swinton, E. D. (Ernest Dunlop)	Swinton, E. D (Ernest Dunlop)
Swanson, Neil H. (Neil Harmon)	Swanson, Neil H. (Neil Harmon)	Swanson, Neil H (Neil Harmon)
Whiteing, Richard	Whiteing, Richard	Whiteing,Richard
Whitaker, R. H. (Robert H.)	Whitaker, R. H. (Robert H.)	Whitaker, R. H
White, Fred M. (Fred Merrick)	White, Fred M	White, Fred M. (Fred Merrick)
Whitechurch, Victor L. (Victor Lorenzo)	Whitechurch, Victor L. (Victor Lorenzo)	Whitechurch, Victor L
White, E. B. (Elwyn Brooks)	White, E. B (Elwyn Brooks)	White, E. B. (Elwyn Brooks)
White, Nelia (Gardner), Mrs	White, Nelia Gardner	White, Nelia (Gardner), Mrs	White, Nelia Gardner, Mrs
Wheeler, William Lamont, Mrs	Wheeler, William Lamont	Wheeler, William Lamont, Mrs
White, Theodore H. (Theodore Harold)	White, Theodore H (Theodore Harold)	White, Theodore H. (Theodore Harold)
White, T. H. (Terence Hanbury)	White, T. H. (Terence Hanbury)	White, T. H (Terence Hanbury)
Whyte-Melville, G. J. (George John)	Whyte-Melville, G. J. (George John)	Whyte-Melville, G. J
Whitney, A. D. T. (Adeline Dutton Train)	Whitney, A. D. T. (Adeline Dutton Train)	Whitney, A. D. T
freifrau von, Tautphœus, Jemima (Montgomery)	freifrau von, Tautphœus, Jemima Montgomery	freifrau von, Tautphœus, Jemima (Montgomery)
friherrinna, Aminoff, Constance Léonie Caroline Borgström	friherrinna, Aminoff, Constance Leonie Caroline Borgström	friherrinna, Aminoff, Constance Léonie Caroline Borgström
Edwards, H. Sutherland (Henry Sutherland)	Edwards, H. Sutherland	Edwards, H. Sutherland (Henry Sutherland)
Dilke, Charles Wentworth, Sir	Dilke, Charles Wentworth	Dilke, Charles Wentworth, Sir
Dillon, Henry Augustus Dillon-Lee	Dillon, Henry Augustus	Dillon, Henry Augustus Dillon-Lee
Dixon, Pierson, Sir	Dixon, Pierson	Dixon, Pierson, Sir
Dimock, A. W. (Anthony Weston)	Dimock, A. W	Dimock, A. W. (Anthony Weston)
Dillon, Mary (Mary C. Johnson)	Dillon, Mary C. Johnson	Dillon, Mary C. (Johnson)	Dillon, Mary C. Johnson, Mrs	Dillon, Mary (Mary C. Johnson)
Divine, A. D. (Arthur Durham)	Divine, A. D. (Arthur Durham)	Divine, A. D (Arthur Durham)
Diaz, Mrs. Abby Morton	Diaz, Mrs. Abby Morton	Diaz, Abby Morton
Dickinson, Anna E. (Anna Elizabeth)	Dickinson, Anna E. (Anna Elizabeth)	Dickinson, Anna E
Austin, F. Britten (Frederick Britten)	Austin, F. Britten	Austin, F. Britten (Frederick Britten)
Austin, Jane G. (Jane Goodwin)	Austin, Jane G. (Jane Goodwin)	Austin, Jane G
Urbino, L. B. (Levina Buoncuore)	Urbino, L. B. (Levina Buoncuore)	Urbino, L. B
Blox, John E.	Blox, John E	Blox, John E.]
Blythe, Samuel G. (Samuel George)	Blythe, Samuel G. (Samuel George)	Blythe, Samuel G
Blessington, Marguerite, Countess of	Blessington, Marguerite, Countess of	Blessington, Marguerite
Blackmore, R. D. (Richard Dooddridge)	Blackmore, R. D (Richard Doddridge)	Blackmore, R. D	Blackmore, R. D. (Richard Doddridge)	Blackmore, R. D. (Richard Dooddridge)
Bloundelle-Burton, John Edward	Bloundelle-Burton, John	Bloundelle-Burton, John Edward
Blackford, (Martha), Mrs	Blackford, Martha	Blackford, (Martha), Mrs
Blavatsky, H. P. (Helena Petrovna)	Blavatsky, H. P. (Helena Petrovna)	Blavatsky, H. P
Bleek, W. H. I. (Wilhelm Heinrich Immanuel)	Bleek, W. H. I. (Wilhelm Heinrich Immanuel)	Bleek, W. H. I (Wilhelm Heinrich Immanuel)
Oxley, James MacDonald	Oxley, James MacDonald	Oxley, James Macdonald
Oxley, J. Macdonald (James Macdonald)	Oxley, J. Macdonald (James Macdonald)	Oxley, J. Macdonald
condesa de, Pardo Bazán, Emilia	condesa de, Pardo Bazán, Emilia	condesa de, Pardo Bazán, Emilia
comtesse de, Genlis, Stéphanie Félicité	comtesse de, Genlis, Stéphanie Félicité	comtesse de, Genlis, Stéphanie Félicité
Wright, J. W. (Jacob William)	Wright, J. W	Wright, J. W. (Jacob William)
Wright, Mary (Tappan), Mrs	Wright, Mary (Tappan), Mrs	Wright, Mary Tappan	Wright, Mary Tappan, Mrs
Kuprin, A. I. (Aleksandr Ivanovich)	Kuprin, A. I	Kuprin, A. I (Aleksandr Ivanovich)	Kuprin, A. I. (Aleksandr Ivanovich)
Kuzmin, M. A. (Mikhail Alekseevich)	Kuzmin, M. A (Mikhail Alekseevich)	Kuzmin, M. A. (Mikhail Alekseevich)
Kuncewiczowa, Maria Szczepańska	Kuncewiczowa, Maria Szczepańska	Kuncewiczowa, Maria Szczepańska
Ilsley, Charles P. (Charles Parker)	Ilsley, Charles P	Ilsley, Charles P. (Charles Parker)
Burnand, F. C. (Francis Cowley), Sir	Burnand, F. C	Burnand, F. C. (Francis Cowley), Sir	Burnand, F. C. (Francis Cowley)
Burgess, Thornton W. (Thornton Waldo)	Burgess, Thornton W	Burgess, Thornton W. (Thornton Waldo	Burgess, Thornton W. (Thornton Waldo)
Buckley, William F. (William Frank)	Buckley, William F (William Frank)	Buckley, William F. (William Frank)
Butler, William Francis, Sir	Butler, William Francis	Butler, William Francis, Sir
Burdett, C. D, Mrs	Burdett, C. D	Burdett, C. D, Mrs
Burrows, E, Mrs	Burrows, E	Burrows, E, Mrs
Burnett, Frances (Hodgson)	Burnett, Frances Hodgson	Burnett, Frances (Hodgson)
Bury, Charlotte Campbell, Lady	Bury, Charlotte Campbell	Bury, Charlotte Campbell, Lady
Burdette, Robert J. (Robert Jones)	Burdette, Robert J. (Robert Jones)	Burdette, Robert J
Burke, T. A. (Thomas A.)	Burke, T. A. (Thomas A.)	Burke, T. A
Buck, Pearl S. (Pearl Sydenstricker)	Buck, Pearl S. (Pearl Sydenstricker)	Buck, Pearl S (Pearl Sydenstricker)
Burgin, G. B. (George Brown)	Burgin, G. B	Burgin, G. B. (George Brown)
Bunner, H. C. (Henry Cuyler)	Bunner, H. C	Bunner, H. C. (Henry Cuyler)
Buckmaster, Henrietta, pseud	Buckmaster, Henrietta	Buckmaster, Henrietta, pseud
Idriess, Ion L. (Ion Llewellyn)	Idriess, Ion L (Ion Llewellyn)	Idriess, Ion L. (Ion Llewellyn)
Temple, Dorothy (Osborne)	Temple, Dorothy (Osborne)	Temple, Dorothy Osborne
Tencin, Claudine Alexandrine Guérin de	Tencin, Claudine Alexandrine Guérin de	Tencin, Claudine Alexandrine Guérin de
Findlater, Jane Helen	Findlater Jane Helen	Findlater, Jane Helen
Field, Isobel (Osbourne), Mrs	Field, Isobel Osbourne	Field, Isobel (Osbourne), Mrs
Fischer, Henry W. (Henry William)	Fischer, Henry W	Fischer, Henry W. (Henry William)
Fitchett, W. H. (William Henry)	Fitchett, W. H	Fitchett, W. H. (William Henry)
Finney, Charles G. (Charles Grandison)	Finney, Charles G (Charles Grandison)	Finney, Charles G. (Charles Grandison)
Fisher, Anne (Benson) Mrs	Fisher, Anne Benson	Fisher, Anne (Benson) Mrs
Fielding, H. (Harold)	Fielding, H	Fielding, H. (Harold)
Field, Henrietta (Dexter), Mrs	Field, Henrietta (Dexter)	Field, Henrietta (Dexter), Mrs
Dryer, Bernard V. (Bernard Victor)	Dryer, Bernard V (Bernard Victor)	Dryer, Bernard V. (Bernard Victor)
Drain, James A.	Drain, James A. [from old catalog]	Drain, James A
Elliot, Samuel H. (Samuel Hayes)	Elliot, Samuel H	Elliot, Samuel H. (Samuel Hayes)
Elliott, Lizzie P. (Lizzie Porterfield)	Elliott, Lizzie P. (Lizzie Porterfield)	Elliott, Lizzie P
Elson, William H. (William Harris)	Elson, William H	Elson, William H. (William Harris)
Ellwanger, George H. (George Herman)	Ellwanger, George H	Ellwanger, George H. (George Herman)
Ellis, J. Breckenridge (John Breckenridge)	Ellis, J. Breckenridge (John Breckenridge)	Ellis, J. Breckenridge
Vulliamy, C. E. (Colwyn Edward)	Vulliamy, C. E (Colwyn Edward)	Vulliamy, C. E. (Colwyn Edward)
Slosson, Annie (Trumbull), Mrs	Slosson, Annie (Trumbull), Mrs	Slosson, Annie Trumbull, Mrs	Slosson, Annie (Trumbull)	Slosson, Annie Trumbull
Slaughter, Frank G. (Frank Gill)	Slaughter, Frank G. (Frank Gill)	Slaughter, Frank G (Frank Gill)
Slaughter, Gertrude Elizabeth (Taylor)	Slaughter, Gertrude Elizabeth Taylor	Slaughter, Gertrude Elizabeth (Taylor)
Knipe, Emilie (Benson), Mrs	Knipe, Emilie (Benson), Mrs	Knipe, Emilie Benson
Tuckerman, Henry T. (Henry Theodore)	Tuckerman, Henry T. (Henry Theodore)	Tuckerman, Henry T (Henry Theodore)
Turczynowicz, Laura (Blackwell) de Gozdawa	Turczynowicz, Laura (Blackwell) de Gozdawa	Turczynowicz, Laura Blackwell de Gozdawa
Isaman, Sara (White)	Isaman, Sara (White)	Isaman, Sara White
Musick, John R. (John Roy)	Musick, John R	Musick, John R. (John Roy)	Musick, John R (John Roy)
Murray, Charles Augustus, Sir	Murray, Charles Augustus, Sir	Murray, Charles Augustus
Muse, Benjamin	Muse, Benjamin	Muse, Benjamin. [from old catalog]
Murray, W. H. H. (William Henry Harrison)	Murray, W. H. H	Murray, W. H. H. (William Henry Harrison)
Muddock, J. E. (Joyce Emmerson Preston)	Muddock, J. E. (Joyce Emmerson Preston)	Muddock, J. E. (Joyce Emmerson)
Scott, Evelyn, Mrs	Scott, Evelyn, Mrs	Scott, Evelyn
Scott-James, R. A. (Rolfe Arnold)	Scott-James, R. A. (Rolfe Arnold)	Scott-James, R. A
Schaeffer, L. M. (Luther Melanchthon)	Schaeffer, L. M. (Luther Melanchthon)	Schaeffer, L. M
Scully, W. C. (William Charles)	Scully, W. C	Scully, W. C. (William Charles)
Scott, Walter, Sir	Scott, Walter, Sir	Scott, Walter
Scott, J. D. (John Dick)	Scott, J. D (John Dick)	Scott, J. D. (John Dick)
Scudder, Horace Elisha	Scudder, Horace Elisha	Scudder, Horace Elisha. [from old catalog]
Schaeffer, Evelyn (Schuyler), Mrs	Schaeffer, Evelyn (Schuyler)	Schaeffer, Evelyn (Schuyler), Mrs
Schuyler, George S.   (George Samuel)	Schuyler, George S (George Samuel)	Schuyler, George S.   (George Samuel)
Schwarz, Leo W. (Leo Walder)	Schwarz, Leo W (Leo Walder)	Schwarz, Leo W. (Leo Walder)
Viramontes, Helena María	Viramontes, Helena Maria	Viramontes, Helena María
Viscount, Slim, William Joseph Slim	Viscount, Slim, William Slim	Viscount, Slim, William Joseph Slim
Roberts, Charles G. D., Sir	Roberts, Charles G. D	Roberts, Charles G. D, Sir	Roberts, Charles G. D., Sir
Rosenbach, A. S. W. (Abraham Simon Wolf)	Rosenbach, A. S. W. (Abraham Simon Wolf)	Rosenbach, A. S. W
Roland Wilkins. Wilkins, Louisa (Jebb), Mrs	Roland Wilkins. Wilkins, Louisa (Jebb), Mrs	Roland Wilkins. Wilkins, Louisa Jebb, Mrs
Roberts, S. C. (Sydney Castle)	Roberts, S. C (Sydney Castle)	Roberts, S. C. (Sydney Castle)
Robinson, Eliot H. (Eliot Harlow)	Robinson, Eliot H. (Eliot Harlow)	Robinson, Eliot H
Roe, Frances Marie Antoinette Mack	Roe, Frances Marie Antoinette Mack	Roe, Frances Marie Antoinette
Robinson, F. W. (Frederick William)	Robinson, F. W	Robinson, F. W. (Frederick William)
Root, Esther Sayles	Root, Esther Sayles	Root, Esther Sayles. [from old catalog]
Robinson, William J. (William Josephus)	Robinson, William J	Robinson, William J. (William Josephus)
Roberts, Charles George Douglas, Sir	Roberts, Charles George Douglas	Roberts, Charles George Douglas, Sir
Robinson, H. Perry (Harry Perry)	Robinson, H. Perry	Robinson, H. Perry (Harry Perry)
Roe, Vingie E. (Vingie Eve)	Roe, Vingie E	Roe, Vingie E. (Vingie Eve)
Roberts, C. E. Bechhofer (Carl Eric Bechhofer)	Roberts, C. E. Bechhofer (Carl Eric Bechhofer)	Roberts, C. E. Bechhofer
Robbins, Sarah Stuart, Mrs	Robbins, Sarah Stuart	Robbins, Sarah Stuart, Mrs
Southworth, S. A, Mrs	Southworth, S. A, Mrs	Southworth, S. A
Sothern, E. H. (Edward Hugh)	Sothern, E. H	Sothern, E. H. (Edward Hugh)
Somerville, E. Œ. (Edith Œnone)	Somerville, E. Œ. (Edith Œnone)	Somerville, E. Œ (Edith Œnone)
Soulié de Morant, G. (Georges)	Soulié de Morant, G (Georges)	Soulié de Morant, G. (Georges)
Wodehouse, P. G., (Pelham Grenville)	Wodehouse, P. G., (Pelham Grenville)	Wodehouse, P. G. (Pelham Grenville)	Wodehouse, P. G (Pelham Grenville)
Woolley, Leonard, Sir	Woolley, Leonard, Sir	Woolley, Leonard
Wood, J. G. (John George)	Wood, J. G	Wood, J. G. (John George)
Woodrow, Wilson, Mrs	Woodrow, Wilson, Mrs	Woodrow, Wilson
Wood, Edith (Elmer), Mrs	Wood, Edith (Elmer), Mrs	Wood, Edith Elmer
Wood, Edward D. (Edward Davis)	Wood, Edward D (Edward Davis)	Wood, Edward D. (Edward Davis)
Woodward, R. Pitcher (Robert Pitcher)	Woodward, R. Pitcher (Robert Pitcher)	Woodward, R. Pitcher. [from old catalog]
Powell, G. H. (George Herbert)	Powell, G. H. (George Herbert)	Powell, G. H
Power, M. S (Maurice S)	Power, M. S	Power, M. S (Maurice S)
Powell, Addison M. (Addison Monroe)	Powell, Addison M (Addison Monroe)	Powell, Addison M. (Addison Monroe)	Powell, Addison M
Pollock, Frederick, Sir	Pollock, Frederick	Pollock, Frederick, Sir
Ponder, S. E. G. (Stephen Einar Gilbert)	Ponder, S. E. G. (Stephen Einar Gilbert)	Ponder, S. E. G (Stephen Einar Gilbert)
Poynter, E. Frances (Eleanor Frances)	Poynter, E. Frances	Poynter, E. Frances (Eleanor Frances)
Post, Helen (Wilmans), Mrs	Post, Helen (Wilmans), Mrs	Post, Helen (Wilmans)
Porter, Eleanor H. (Eleanor Hodgman)	Porter, Eleanor H	Porter, Eleanor H. (Eleanor Hodgman)
Powers, J. F. (James Farl)	Powers, J. F (James Farl)	Powers, J. F. (James Farl)
Post, C. C. (Charles Clement)	Post, C. C. (Charles Clement)	Post, C. C
Porter, Rebecca N. (Rebecca Newman)	Porter, Rebecca N. (Rebecca Newman)	Porter, Rebecca N
Grigorovich, D. V. (Dmitriĭ Vasilʹevich)	Grigorovich, D. V. (Dmitriĭ Vasilʹevich)	Grigorovich, D. V (Dmitriĭ Vasilʹevich)
Griggs, S. E. (Stephen Elind)	Griggs, S. E	Griggs, S. E. (Stephen Elind)
Grant Watson, Elliot L. (Elliot Lovegood)	Grant Watson, Elliot L	Grant Watson, Elliot L. (Elliot Lovegood)
Grenfell, Wilfred Thomason, Sir	Grenfell, Wilfred Thomason	Grenfell, Wilfred Thomason, Sir
Grey, (Elizabeth Caroline), Mrs	Grey, Elizabeth Caroline	Grey, (Elizabeth Caroline), Mrs
Gratacap, L. P. (Louis Pope)	Gratacap, L. P. (Louis Pope)	Gratacap, L. P
Graves, Charles L. (Charles Larcom)	Graves, Charles L. (Charles Larcom)	Graves, Charles L
Grosvenor, Abbie (Johnston)	Grosvenor, Abbie Johnston	Grosvenor, Abbie (Johnston)
Greg, William R. (William Rathbone)	Greg, William R. (William Rathbone)	Greg, William R	Greg, William R. (William Rathbone
Griggs, Sutton E.   (Sutton Elbert)	Griggs, Sutton E (Sutton Elbert)	Griggs, Sutton E. (Sutton Elbert)	Griggs, Sutton E	Griggs, Sutton E.   (Sutton Elbert)
Grenfell, Anna Elizabeth Caldwell (MacClanahan)	Grenfell, Anna Elizabeth Caldwell (MacClanahan)	Grenfell, Anna Elizabeth Caldwell MacClanahan
Eastman, Mary H. (Mary Henderson)	Eastman, Mary H	Eastman, Mary H (Mary Henderson)	Eastman, Mary H. (Mary Henderson)
Eaton, Charlotte, Mrs	Eaton, Charlotte, Mrs	Eaton, Charlotte
O'Connor, T. P., Mrs	O'Connor, T. P	O'Connor, T. P., Mrs	O'Connor, T. P, Mrs
O'Brien, Edward J. (Edward Joseph)	O'Brien, Edward J. (Edward Joseph)	O'Brien, Edward J
O'Sullivan, Denis, Mrs	O'Sullivan, Denis	O'Sullivan, Denis, Mrs
Khosla, G. D. (Gopal Das)	Khosla, G. D. (Gopal Das)	Khosla, G. D (Gopal Das)
Baum, L. Frank (Lyman Frank)	Baum, L. Frank	Baum, L. Frank (Lyman Frank)
Bacon, Albion Fellows, Mrs	Bacon, Albion Fellows, Mrs	Bacon, Mrs. Albion Fellows
Banerjea, S. B.	Banerjea, S. B	Banerjea, S.B
Bartlett, Alice E. (Alice Elinor)	Bartlett, Alice E. (Alice Elinor)	Bartlett, Alice E
Barrett, William E.   (William Edmund)	Barrett, William E.   (William Edmund)	Barrett, William E (William Edmund)	Barrett, William E. (William Edmund)
Bain, F. W. (Francis William)	Bain, F. W	Bain, F. W (Francis William)	Bain, F. W. (Francis William)
Bacon, Josephine Dodge (Daskam), Mrs	Bacon, Josephine Dodge (Daskam), Mrs	Bacon, Josephine Dodge Daskam	Bacon, Mrs. Josephine Dodge Daskam
Ballantyne, R. M. (Robert Michael)	Ballantyne, R. M. (Robert Michael)	Ballantyne, R. M (Robert Michael)	Ballantyne, R. M
Bates, Josephine W. (Josephine White)	Bates, Josephine W. (Josephine White)	Bates, Josephine W
Bain, R. Nisbet (Robert Nisbet)	Bain, R. Nisbet	Bain, R. Nisbet (Robert Nisbet)
Barker, A. L. (Audrey Lillian)	Barker, A. L (Audrey Lillian)	Barker, A. L. (Audrey Lillian)
Barash, Asher	Barash, Asher	Barash ,Asher
Banks, G. Linnaeus (George Linnaeus), Mrs	Banks, G. Linnaeus (George Linnaeus), Mrs	Banks, G. Linnaeus
Barton, William Eleazar, 1861-1930	Barton, William Eleazar, 1861-1930	Barton, William Eleazar
Barbey d'Aurevilly, J. (Jules)	Barbey d'Aurevilly, J. (Jules)	Barbey d'Aurevilly, J (Jules)
Barclay, Hubert, Mrs	Barclay, Hubert	Barclay, Hubert, Mrs
Balfour, Andrew, Sir	Balfour, Andrew, Sir	Balfour, Andrew
Barnes, Josiah	Barnes, Josiah. [from old catalog]	Barnes, Josiah
Babelʹ, I. (Isaak)	Babelʹ, I. (Isaak)	Babelʹ, I (Isaak)
Bailey, James M. (James Montgomery)	Bailey, James M	Bailey, James M. (James Montgomery)
Bartlett, W. C. (William Chambers)	Bartlett, W. C. (William Chambers)	Bartlett, W. C
Bartley, Nalbro Isadorah, Mrs	Bartley, Nalbro Isadorah, Mrs	Bartley, Nalbro Isadorah
Bailey, H. C. (Henry Christopher)	Bailey, H. C	Bailey, H. C. (Henry Christopher)
Barclay, Florence L. (Florence Louisa)	Barclay, Florence L. (Florence Louisa)	Barclay, Florence L
Barnum, P. T. (Phineas Taylor)	Barnum, P. T. (Phineas Taylor)	Barnum, P. T
Baker, Samuel White, Sir	Baker, Samuel White, Sir	Baker, Samuel White
Baldwin, Joseph G. (Joseph Glover)	Baldwin, Joseph G. (Joseph Glover)	Baldwin, Joseph G
Barnes, Will C. (Will Croft)	Barnes, Will C	Barnes, Will C. (Will Croft)
Barbour, A. Maynard (Anna Maynard)	Barbour, A. Maynard (Anna Maynard)	Barbour, A. Maynard
Baring-Gould, S. (Sabine)	Baring-Gould, S	Baring-Gould, S. (Sabine)
Bayly, (Mary), Mrs	Bayly, (Mary), Mrs	Bayly, Mary
Bates, H. E. (Herbert Ernest)	Bates, H. E. (Herbert Ernest)	Bates, H. E (Herbert Ernest)
Bazhov, P. P. (Pavel Petrovich)	Bazhov, P. P. (Pavel Petrovich)	Bazhov, P. P (Pavel Petrovich)
Barrie, J. M. (James Matthew)	Barrie, J. M. (James Matthew)	Barrie, J. M (James Matthew)	Barrie, J. M
Bashford, H. H. Sir, (Henry Howarth)	Bashford, H. H. Sir, (Henry Howarth)	Bashford, H. H. (Henry Howarth), Sir
Bates, E. Katherine (Emily Katherine)	Bates, E. Katherine	Bates, E. Katherine (Emily Katherine)
Balzac, Honore   de	Balzac, Honore   de	Balzac, Honore de
Shane, Peggy (Smith)], Mrs	[Shane, Peggy (Smith)], Mrs	[Shane, Peggy (Smith)]
Reynolds, E. W. (Elhanan Winchester)	Reynolds, E. W	Reynolds, E. W. (Elhanan Winchester)
Reed, Earl H. (Earl Howell)	Reed, Earl H	Reed, Earl H. (Earl Howell)
Reeves, Ira L. (Ira Louis)	Reeves, Ira L. (Ira Louis)	Reeves, Ira L
Reynolds, George W. M. (George William MacArthur)	Reynolds, George W. M	Reynolds, George W. M. (George William MacArthur)
Reynolds, Baillie, Mrs	Reynolds, Baillie	Reynolds, Baillie, Mrs
Rees, Arthur J. (Arthur John)	Rees, Arthur J	Rees, Arthur J. (Arthur John)
Reeve, Arthur B. (Arthur Benjamin)	Reeve, Arthur B. (Arthur Benjamin)	Reeve, Arthur B
Reed, A. W. (Alexander Wyclif)	Reed, A. W (Alexander Wyclif)	Reed, A. W. (Alexander Wyclif)
Reeve, F. D. (Franklin D.)	Reeve, F. D (Franklin D.)	Reeve, F. D. (Franklin D.)
Synge, J. M. (John Millington)	Synge, J. M	Synge, J. M. (John Millington)
Underwood, Edna (Worthley), Mrs	Underwood, Edna (Worthley), Mrs	Underwood, Edna Worthley, Mrs	Underwood, Edna Worthley
Kaverin, V. (Veniamin)	Kaverin, V. (Veniamin)	Kaverin, V (Veniamin)
Kaberlein, Joseph J. (Joseph James)	Kaberlein, Joseph J. (Joseph James)	Kaberlein, Joseph J (Joseph James)
De Leon, T. C. (Thomas Cooper)	De Leon, T. C. (Thomas Cooper)	De Leon, T. C
De Saussure, N. B. (Nancy Bostick), Mrs	De Saussure, N. B	De Saussure, N. B. (Nancy Bostick), Mrs	De Saussure, N. B. Mrs (Nancy Bostick)
De Berard, Frederick B. (Frederick Brigham)	De Berard, Frederick B	De Berard, Frederick Brigham	De Berard, Frederick B. (Frederick Brigham)
Deming, Therese (Osterheld), Mrs	Deming, Therese (Osterheld)	Deming, Therese (Osterheld), Mrs
De Kroyft, Helen (Aldrich), Mrs	De Kroyft, Helen (Aldrich)	De Kroyft, Helen (Aldrich), Mrs	De Kroyft, Helen Aldrich
Denison, Mary A. (Mary Andrews)	Denison, Mary A. (Mary Andrews)	Denison, Mary A
Dell, Ethel M. (Ethel May)	Dell, Ethel M. (Ethel May)	Dell, Ethel M
De La Pasture, Henry, Mrs	De La Pasture, Henry, Mrs	De La Pasture, Henry
Faversham, Julie (Opp)	Faversham, Julie (Opp)	Faversham, Julie Opp
Farrell, James T. (James Thomas)	Farrell, James T. (James Thomas)	Farrell, James T (James Thomas)
Faure, Raoul C. (Raoul Cohen)	Faure, Raoul C (Raoul Cohen)	Faure, Raoul C. (Raoul Cohen)
Farrar, Charles A. J. (Charles Alden John)	Farrar, Charles A. J	Farrar, Charles A. J. (Charles Alden John)
Fay, Theodore S. (Theodore Sedgwick)	Fay, Theodore S. (Theodore Sedgwick)	Fay, Theodore S
Farjeon, B. L. (Benjamin Leopold)	Farjeon, B. L. (Benjamin Leopold)	Farjeon, B. L
Farnham, Eliza W. (Eliza Wood)	Farnham, Eliza W	Farnham, Eliza W. (Eliza Wood)
Farrar, F. W. (Frederic William)	Farrar, F. W (Frederic William)	Farrar, F. W	Farrar, F. W. (Frederic William)
Ervine, St. John G. (St. John Greer)	Ervine, St. John G	Ervine, St. John G. (St. John Greer)
Veresaev, V. V. (Vikentiĭ Vikentʹevich)	Veresaev, V. V (Vikentiĭ Vikentʹevich)	Veresaev, V. V. (Vikentii Vikentevich)	Veresaev, V. V. (Vikentiĭ Vikentʹevich)	Veresaev, V. V
Warfield, Catherine Ann (Catherine Ann Ware)	Warfield, Catherine Ann (Catherine Ann)	Warfield, Catherine Ann Ware	Warfield, Catherine Ann (Catherine Ann Ware)
Watson, Augusta (Campbell), Mrs	Watson, Augusta (Campbell), Mrs	Watson, Augusta Campbell
Walker, Charles R. (Charles Rumford)	Walker, Charles R (Charles Rumford)	Walker, Charles R. (Charles Rumford)	Walker, Charles R
Wade, Horace (Horace Atkisson)	Wade, Horace (Horace Atkisson)	Wade, Horace Atkisson
Walton, O. F., Mrs	Walton, O. F., Mrs	Walton, O. F, Mrs
Washburn, Charles A. (Charles Ames)	Washburn, Charles A. (Charles Ames)	Washburn, Charles A
Warren, Maude Radford (Maude Lavinia Radford)	Warren, Maude Radford	Warren, Maude Radford (Maude Lavinia Radford)	Warren, Maude Lavinia Radford
Ward, R. Plumer (Robert Plumer)	Ward, R. Plumer	Ward, R. Plumer (Robert Plumer)
Ward, Catherine G. (Catherine George)	Ward, Catherine G	Ward, Catherine G. (Catherine George)
Waterman, Arba N. (Arba Nelson)	Waterman, Arba N. (Arba Nelson)	Waterman, Arba N
Ward, Wilfrid, Mrs	Ward, Wilfrid	Ward, Wilfrid, Mrs
Wadelton, Maggie Jeanne (Melody) Mrs	Wadelton, Maggie Jeanne (Melody) Mrs	Wadelton, Maggie Jeanne (Melody)
Ward, F. Marshall, Mrs	Ward, F. Marshall	Ward, F. Marshall, Mrs
Waller, Mary E. (Mary Ella)	Waller, Mary E. (Mary Ella)	Waller, Mary E
Walter, Otto F. (Otto Friedrich)	Walter, Otto F (Otto Friedrich)	Walter, Otto F. (Otto Friedrich)
Ware, Mary Smith Dabney, Mrs	Ware, Mary Smith Dabney	Ware, Mary Smith Dabney, Mrs
Watson, Thomas E. (Thomas Edward)	Watson, Thomas E (Thomas Edward)	Watson, Thomas E. (Thomas Edward)
Waddington, Mary Alsop King, Mme	Waddington, Mary Alsop (King)	Waddington, Mary Alsop King, Mme
Walpole, Hugh, Sir	Walpole, Hugh, Sir	Walpole, Hugh
Warfel, Harry R. (Harry Redcay)	Warfel, Harry R (Harry Redcay)	Warfel, Harry R. (Harry Redcay)
Watanna, Onoto, Mrs	Watanna, Onoto, Mrs	Watanna, Onoto
Snow, C. P. (Charles Percy)	Snow, C. P (Charles Percy)	Snow, C. P. (Charles Percy)
Snaith, J. C. (John Collis)	Snaith, J. C. (John Collis)	Snaith, J. C
Snyder, Charles M. (Charles McCoy)	Snyder, Charles M. (Charles McCoy)	Snyder, Charles M
Snider, C. H. J. (Charles Henry Jeremiah)	Snider, C. H. J. (Charles Henry Jeremiah)	Snider, C. H. J
Snell, Roy J. (Roy Judson)	Snell, Roy J	Snell, Roy J. (Roy Judson)
Oemler, Marie (Conway), Mrs	Oemler, Marie Conway, Mrs	Oemler, Marie (Conway)	Oemler, Marie (Conway) Mrs	Oemler, Marie Conway	Oemler, Marie (Conway), Mrs
Koontz, Dean R. (Dean Ray)	Koontz, Dean R. (Dean Ray)	Koontz, Dean R (Dean Ray)
Kovalevskai͡a, S. V. (Sofʹi͡a Vasilʹevna)	Kovalevskai͡a, S. V. (Sofʹi͡a Vasilʹevna)	Kovalevskai͡a, S. V (Sofʹi͡a Vasilʹevna)
Andrews, Mary Raymond (Shipman), Mrs	Andrews, Mary Raymond (Shipman)	Andrews, Mary Raymond (Shipman), Mrs
Andrēasean, A. (Andranik)	Andrēasean, A (Andranik)	Andrēasean, A. (Andranik)
Andress, J. Mace (James Mace)	Andress, J. Mace (James Mace)	Andress, J. Mace
Andersen, H. C. (Hans Christian)	Andersen, H. C. (Hans Christian)	Andersen, H. C (Hans Christian)	Andersen, H. C
Anderson, A. J. (Arthur James)	Anderson, A. J. (Arthur James)	Anderson, A. J
Anderdon, W. H. (William Henry)	Anderdon, W. H (William Henry)	Anderdon, W. H. (William Henry)
Norris, W. E. (William Edward)	Norris, W. E. (William Edward)	Norris, W. E
Noel, Augusta (Keppel), Lady	Noel, Lady Augusta (Keppel)	Noel, Augusta (Keppel), Lady
Northrup, A. Judd (Ansel Judd)	Northrup, A. Judd	Northrup, A. Judd (Ansel Judd)
Novikov-Priboĭ, A. S. (Alekseĭ Silych)	Novikov-Priboĭ, A. S (Alekseĭ Silych)	Novikov-Priboĭ, A. S. (Alekseĭ Silych)
Jameson, Annie Edith Foster], Mrs	[Jameson, Annie Edith Foster	[Jameson, Annie Edith Foster], Mrs	[Jameson, Annie Edith Foster, Mrs
Dunn, Byron A. (Byron Archibald)	Dunn, Byron A. (Byron Archibald)	Dunn, Byron A
Dunlop, Madeline Anne Wallace-	Dunlop, Madeline Anne Wallace	Dunlop, Madeline Anne Wallace-
Dupuy, Eliza A. (Eliza Ann)	Dupuy, Eliza A	Dupuy, Eliza A. (Eliza Ann)
Du Bois, W. E. B. (William Edward Burghardt)	Du Bois, W. E. B (William Edward Burghardt)	Du Bois, W. E. B. (William Edward Burghardt)
Du Chaillu, Paul B. (Paul Belloni)	Du Chaillu, Paul B. (Paul Belloni)	Du Chaillu, Paul B
Du Boisgobey, Fortuné	Du Boisgobey, Fortune	Du Boisgobey, Fortuné
Dunsany, Edward John Moreton Drax Plunkett, Baron	Dunsany, Edward John Moreton Drax Plunkett, Baron	Dunsany, Edward John Moreton Drax Plunkett
Ingraham, J. H. (Joseph Holt)	Ingraham, J. H. (Joseph Holt)	Ingraham, J. H
Inchbold, A. C. (A. Cunnick)	Inchbold, A. C	Inchbold, A. C. (A. Cunnick)
Ingram, Eleanor M. (Eleanor Marie)	Ingram, Eleanor M. (Eleanor Marie)	Ingram, Eleanor M
Inglis, Henry D. (Henry David)	Inglis, Henry D (Henry David)	Inglis, Henry D. (Henry David)
Rucker, Rudy v. B. (Rudy von Bitter)	Rucker, Rudy v. B (Rudy von Bitter)	Rucker, Rudy v. B. (Rudy von Bitter)
Russell, William Howard, Sir	Russell, William Howard	Russell, William Howard, Sir
Bingham, Mrs. Kate Boyles	Bingham, Kate Boyles	Bingham, Mrs. Kate Boyles
Bigham, Madge A. (Madge Alford)	Bigham, Madge A. (Madge Alford)	Bigham, Madge A
Binstead, Arthur M. (Arthur Morris)	Binstead, Arthur M	Binstead, Arthur M. (Arthur Morris)
Bicknell, Frank M. (Frank Martin)	Bicknell, Frank M	Bicknell, Frank M. (Frank Martin)
Bickley, Francis Lawrence	Bickley, Francis Lawrence	Bickley, Francis Lawrance
Bigelow, Edith Evelyn (Jaffray)	Bigelow, Edith Evelyn	Bigelow, Edith Evelyn (Jaffray)
Abbott, Mary Perkins (Ives), Mrs	Abbott, Mary Perkins (Ives)	Abbott, Mary Perkins Ives	Abbott, Mary Perkins (Ives), Mrs
Abell, Lucia Elizabeth (Balcombe), Mrs	Abell, Lucia Elizabeth (Balcombe), Mrs	Abell, Lucia Elizabeth Balcombe
Sidney, Philip, Sir	Sidney, Philip	Sidney, Philip, Sir
Sisson, C. H. (Charles Hubert)	Sisson, C. H (Charles Hubert)	Sisson, C. H. (Charles Hubert)
Sime, J. G. (Jessie Georgina)	Sime, J. G (Jessie Georgina)	Sime, J. G. (Jessie Georgina)
Sigourney, L. H. (Lydia Howard)	Sigourney, L. H	Sigourney, L. H. (Lydia Howard)
Simpson, E. Blantyre (Evelyn Blantyre)	Simpson, E. Blantyre	Simpson, E. Blantyre (Evelyn Blantyre)
Sims, Mrs. Marian (McCamy)	Sims, Marian McCamy	Sims, Mrs. Marian (McCamy)
Sidgwick, Alfred, Mrs	Sidgwick, Alfred, Mrs	Sidgwick, Alfred
Phelps, E. Stuart (Elizabeth Stuart)	Phelps, E. Stuart (Elizabeth Stuart)	Phelps, E. Stuart
Phra Thēpwisutthimēthī (Ngư̄am)	Phra Thēpwisutthimēthī (Ngūam)	Phra Thēpwisutthimēthī (Ngư̄am)
Ober, Frederick A. (Frederick Albion)	Ober, Frederick A	Ober, Frederick A. (Frederick Albion)
Obruchev, V. A. (Vladimir Afanasʹevich)	Obruchev, V. A (Vladimir Afanasʹevich)	Obruchev, V. A. (Vladimir Afanasʹevich)
Fraser, Hugh, Mrs	Fraser, Hugh	Fraser, Hugh, Mrs
Freiherr de, La Motte-Fouqué, Friedrich Heinrich Karl	Freiherr de, La Motte-Fouqué, Friedrich Heinrich Karl	Freiherr de, La Motte-Fouqué, Friedrich Heinrich Karl
Friedman, I. K. (Isaac Kahn)	Friedman, I. K	Friedman, I. K. (Isaac Kahn)
Frederick, John T. (John Towner)	Frederick, John T (John Towner)	Frederick, John T. (John Towner)
Frankland, Edward  Percy	Frankland, Edward  Percy	Frankland, Edward Percy
Freeman, Mary Eleanor (Wilkins), Mrs	Freeman, Mary Eleanor Wilkins	Freeman, Mary Eleanor (Wilkins), Mrs
French, Harry W. (Harry Willard)	French, Harry W	French, Harry W. (Harry Willard)
Freeman, Lewis R. (Lewis Ransome)	Freeman, Lewis R. (Lewis Ransome)	Freeman, Lewis R
Friel, Arthur O. (Arthur Olney)	Friel, Arthur O. (Arthur Olney)	Friel, Arthur O
Frey, Albert R. (Albert Romer)	Frey, Albert R	Frey, Albert R. (Albert Romer)
Friedman, B. H. (Bernard Harper)	Friedman, B. H (Bernard Harper)	Friedman, B. H. (Bernard Harper)
Haviland, Laura S. (Laura Smith)	Haviland, Laura S (Laura Smith)	Haviland, Laura S. (Laura Smith)
Hall, S. C., Mrs	Hall, S. C	Hall, S. C., Mrs	Hall, S. C, Mrs
Hale, Lucretia P. (Lucretia Peabody)	Hale, Lucretia P (Lucretia Peabody)	Hale, Lucretia P	Hale, Lucretia P. (Lucretia Peabody)
Harben, Will N. (William Nathaniel)	Harben, Will N. (William Nathaniel)	Harben, Will N. (Will Nathaniel)	Harben, Will N
Haviland, Maud D. (Maud Doria)	Haviland, Maud D	Haviland, Maud D. (Maud Doria)
Haig-Brown, Roderick Langmere	Haig-Brown, Roderick Langmere	Haig-Brown, Roderick L
Hamley, W. G. (William George)	Hamley, W. G. (William George)	Hamley, W. G
Hales, A. G. (Alfred Greenwood)	Hales, A. G	Hales, A. G. (Alfred Greenwood)
Harrison, Burton, Mrs	Harrison, Burton	Harrison, Burton, Mrs
Hancock, H. Irving (Harrie Irving)	Hancock, H. Irving	Hancock, H. Irving (Harrie Irving)
Hamill, Katherine B. (Katherine Bernie)	Hamill, Katherine B	Hamill, Katherine B. (Katherine Bernie)
Haldeman-Julius, E. (Emanuel)	Haldeman-Julius, E. (Emanuel)	Haldeman-Julius, E
Harding, John W. (John William)	Harding, John W	Harding, John W. (John William)
Haggard, H. Rider (Henry Rider)	Haggard, H. Rider	Haggard, H. Rider (Henry Rider)
Hall, Angus W, Mrs	Hall, Angus W	Hall, Angus W, Mrs
Hayes, Clair W. (Clair Wallace)	Hayes, Clair W. (Clair Wallace)	Hayes, Clair W
Harman, Michael Garber	Harman, Michael Garber. [from old catalog]	Harman, Michael Garber
Hart, Frances (Noyes), Mrs	Hart, Frances Noyes	Hart, Frances (Noyes), Mrs
Harker, L. Allen (Lizzie Allen), Mrs	Harker, L. Allen	Harker, L. Allen (Lizzie Allen), Mrs	Harker, L. Allen (Lizzie Allen)
Hayes, I. I. (Isaac Israel)	Hayes, I. I. (Isaac Israel)	Hayes, I. I
Hassaurek, F. (Friedrich)	Hassaurek, F	Hassaurek, F. (Friedrich)
Hamley, Edward Bruce, Sir	Hamley, Edward Bruce, Sir	Hamley, Edward Bruce
Haven, Alice B. (Alice Bradley)	Haven, Alice B. (Alice Bradley)	Haven, Alice B
Harney, W. E. (William Edward)	Harney, W. E (William Edward)	Harney, W. E. (William Edward)
Hare, Augustus J. C. (Augustus John Cuthbert)	Hare, Augustus J. C	Hare, Augustus J. C. (Augustus John Cuthbert)
Hamilton, J. (John)	Hamilton, J	Hamilton, J. (John)
Hammond, S. H. (Samuel H.)	Hammond, S. H. (Samuel H.)	Hammond, S. H
Krishnamurti, J. (Jiddu)	Krishnamurti, J (Jiddu)	Krishnamurti, J. (Jiddu)	Krishnamurti, J
Krasnov, P. N. (Petr Nikolaevich)	Krasnov, P. N. (Petr Nikolaevich)	Krasnov, P. N (Petr Nikolaevich)
Flygare-Carlén, Emilie (Smith)	Flygare-Carlén, Emilie (Smith)	Flygare-Carlén, Emilie
Fletcher, J. S. (Joseph Smith)	Fletcher, J. S. (Joseph Smith)	Fletcher, J. S (Joseph Smith)	Fletcher, J. S
Flagg, E. E. (Elizabeth E.)	Flagg, E. E	Flagg, E. E. (Elizabeth E.)
Ekvall, Robert B. (Robert Brainerd)	Ekvall, Robert B (Robert Brainerd)	Ekvall, Robert B. (Robert Brainerd)
Emerson, P. H. (Peter Henry)	Emerson, P. H	Emerson, P. H. (Peter Henry)
Ferguson, Samuel, Sir	Ferguson, Samuel, Sir	Ferguson, Samuel
Stauffer, Donald A. (Donald Alfred)	Stauffer, Donald A. (Donald Alfred)	Stauffer, Donald A (Donald Alfred)
Stuefloten, D. N. (Donald N.)	Stuefloten, D. N (Donald N.)	Stuefloten, D. N. (Donald N.)
Street, James H. (James Howell)	Street, James H. (James Howell)	Street, James H (James Howell)
Stanley, Henry M. (Henry Morton)	Stanley, Henry M	Stanley, Henry M. (Henry Morton)
Stacpoole, H. De Vere (Henry De Vere)	Stacpoole, H. De Vere	Stacpoole, H. De Vere (Henry De Vere)
Stenhouse, T. B. H, Mrs	Stenhouse, T. B. H	Stenhouse, T. B. H, Mrs
Stewart, Charles D. (Charles David)	Stewart, Charles D	Stewart, Charles D. (Charles David)
Stearns, J. N. (John Newton)	Stearns, J. N	Stearns, J. N. (John Newton)
Stephen, Harry Lushington, Sir	Stephen, Harry Lushington, Sir	Stephen, Harry Lushington
Stimson, Frederic Jessup	Stimson, Frederic Jessup	Stimson, Frederic Jesup
Stephens, H. Marion (Harriet Marion)	Stephens, H. Marion (Harriet Marion)	Stephens, H. Marion
Stead, W. T. (William Thomas)	Stead, W. T. (William Thomas)	Stead, W. T
Street, G. S. (George Slythe)	Street, G. S	Street, G. S. (George Slythe)
Stribling, T. S. (Thomas Sigismund)	Stribling, T. S. (Thomas Sigismund)	Stribling, T. S (Thomas Sigismund)	Stribling, T. S
Stellman, Louis J. (Louis John)	Stellman, Louis J. (Louis John)	Stellman, Louis J
Stacpoole, Margaret (Robson), Mrs	Stacpoole, Margaret (Robson)	Stacpoole, Margaret (Robson), Mrs
Stephens, C. A. (Charles Asbury)	Stephens, C. A	Stephens, C. A. (Charles Asbury)
Strain, E. H. (Euphans H.)	Strain, E. H	Strain, E. H. (Euphans H.)
Stone, William A. (William Alexis)	Stone, William A (William Alexis)	Stone, William A. (William Alexis)
Stockton, Frank R. (Frank Richard)	Stockton, Frank R. (Frank Richard)	Stockton, Frank R
Stewart, Elinore (Pruitt)	Stewart, Elinore Pruitt	Stewart, Elinore (Pruitt)
Steuart, John A. (John Alexander)	Steuart, John A. (John Alexander)	Steuart, John A
Strong, James C. (James Clark)	Strong, James C. (James Clark)	Strong, James C
Strauss, L. F. (Leopold Frederick)	Strauss, L. F. (Leopold Frederick)	Strauss, L. F
Stead, C. K. (Christian Karlson)	Stead, C. K. (Christian Karlson)	Stead, C. K (Christian Karlson)
Stern, G. B. (Gladys Bronwyn)	Stern, G. B	Stern, G. B. (Gladys Bronwyn)	Stern, G. B (Gladys Bronwyn)
Steele, James W. (James William)	Steele, James W. (James William)	Steele, James W
Stretton, Hesba	Stretton,Hesba	Stretton, Hesba
Stephens, Ann S. (Ann Sophia)	Stephens, Ann S	Stephens, Ann S. (Ann Sophia)
Stewart, J. I. M. (John Innes Mackintosh)	Stewart, J. I. M (John Innes Mackintosh)	Stewart, J. I. M. (John Innes Mackintosh)
St. Johnston, Thomas Reginald, Sir	St. Johnston, Thomas Reginald, Sir	St. Johnston, Thomas Reginald
St. John, Percy B. (Percy Bolingbroke)	St. John, Percy B. (Percy Bolingbroke)	St. John, Percy B (Percy Bolingbroke)
Steevens, G. W. (George Warrington)	Steevens, G. W	Steevens, G. W. (George Warrington)
Stevens, Charles W. (Charles Woodbury)	Stevens, Charles W	Stevens, Charles W. (Charles Woodbury)
Stanley, Caroline (Abbot), Mrs	Stanley, Caroline (Abbot), Mrs	Stanley, Caroline Abbot
Strong, L. A. G. (Leonard Alfred George)	Strong, L. A. G. (Leonard Alfred George)	Strong, L. A. G (Leonard Alfred George)
Gerson, Noel B. (Noel Bertram)	Gerson, Noel B. (Noel Bertram)	Gerson, Noel B (Noel Bertram)
Gerry, Margarita (Spalding)	Gerry, Margarita (Spalding)	Gerry, Margarita Spalding
George, W. L. (Walter Lionel)	George, W. L. (Walter Lionel)	George, W. L
George, John L. (John Lothar)	George, John L. (John Lothar)	George, John L (John Lothar)
Spackman, W. M. (William Mode)	Spackman, W. M. (William Mode)	Spackman, W. M (William Mode)
Spearman, Frank H. (Frank Hamilton)	Spearman, Frank H	Spearman, Frank H. (Frank Hamilton)
Spectorsky, A. C. (Auguste C.)	Spectorsky, A. C (Auguste C.)	Spectorsky, A. C. (Auguste C.)
Spivak, John L. (John Louis)	Spivak, John L. (John Louis)	Spivak, John L (John Louis)
Spencer, Bella Zilfa, Mrs	Spencer, Bella Zilfa	Spencer, Bella Zilfa, Mrs
Speilmann, M. H, Mrs	Speilmann, M. H, Mrs	Speilmann, M. H
Spofford, Harriet Elizabeth Prescott, Mrs	Spofford, Harriet Elizabeth Prescott	Spofford, Harriet Elizabeth Prescott, Mrs
Tyson, J. Aubrey (John Aubrey)	Tyson, J. Aubrey	Tyson, J. Aubrey (John Aubrey)
Thirkell, Angela (Mackail)	Thirkell, Angela Mackail	Thirkell, Angela (Mackail)
Thompson, Daniel P. (Daniel Pierce)	Thompson, Daniel P. (Daniel Pierce)	Thompson, Daniel P
Thurston, E. Temple (Ernest Temple)	Thurston, E. Temple (Ernest Temple)	Thurston, E. Temple
Thruston, Lucy Meacham (Kidd), Mrs	Thruston, Lucy Meacham (Kidd), Mrs	Thruston, Lucy Meacham Kidd	Thruston, Lucy Meacham (Kidd)	Thruston, Lucy Meacham Kidd, Mrs
Theiss, Lewis E. (Lewis Edwin)	Theiss, Lewis E	Theiss, Lewis E. (Lewis Edwin)
Ackerley, J. R. (Joe Randolph)	Ackerley, J. R (Joe Randolph)	Ackerley, J. R. (Joe Randolph)
L. E. L. (Letitia Elizabeth Landon)	L. E. L (Letitia Elizabeth Landon)	L. E. L. (Letitia Elizabeth Landon)
Afanasʹev, A. N. (Aleksandr Nikolaevich)	Afanasʹev, A. N (Aleksandr Nikolaevich)	Afanasʹev, A. N. (Aleksandr Nikolaevich)
Williamson, C. N. (Charles Norris)	Williamson, C. N. (Charles Norris)	Williamson, C. N
Wills, C. J. (Charles James)	Wills, C. J. (Charles James)	Wills, C. J (Charles James)
Wilder, Marshall P. (Marshall Pinckney)	Wilder, Marshall P. (Marshall Pinckney)	Wilder, Marshall P
Wilkins, Louisa (Jebb)	Wilkins, Louisa Jebb	Wilkins, Louisa (Jebb)
Winslow, Thyra (Samter) Mrs	Winslow, Thyra (Samter)	Winslow, Thyra (Samter) Mrs	Winslow, Thyra Samter
Willard, Frances E. (Frances Elizabeth)	Willard, Frances E	Willard, Frances E. (Frances Elizabeth)
Wilkins, W. H. (William Henry)	Wilkins, W. H. (William Henry)	Wilkins, W. H
Wigram, W. Knox (William Knox)	Wigram, W. Knox	Wigram, W. Knox (William Knox)
Williams, H. Noel (Hugh Noel)	Williams, H. Noel	Williams, H. Noel (Hugh Noel)
Wilkins, Vaughan (William Vaughan)	Wilkins, William Vaughan	Wilkins, Vaughan (William Vaughan)
Witwer, H. C. (Harry Charles)	Witwer, H. C	Witwer, H. C. (Harry Charles)
Williams, John (John Edward)	Williams, John (John Edward)	Williams, John Edward
Williams, Joel Strother	Williams, Joel Strother	Williams, Joel Strother. [from old catalog]
Willcocks, M. P. (Mary Patricia)	Willcocks, M. P. (Mary Patricia)	Willcocks, M. P
Williamson, A. M. (Alice Muriel)	Williamson, A. M	Williamson, A. M. (Alice Muriel)
Wilcox, Constance Grenelle	Wilcox, Constance Grenelle. [from old catalog]	Wilcox, Constance Grenelle
Hume, John F. (John Ferguson)	Hume, John F. (John Ferguson)	Hume, John F
Hunter, William Wilson, Sir	Hunter, William Wilson	Hunter, William Wilson, Sir
Hull, Helen R. (Helen Rose)	Hull, Helen R. (Helen Rose)	Hull, Helen R (Helen Rose)
Hulburd, E. W. (Ebenezer Wallace)	Hulburd, E. W	Hulburd, E. W. (Ebenezer Wallace)
Hudson, W. H. (William Henry)	Hudson, W. H (William Henry)	Hudson, W. H	Hudson, W. H. (William Henry)
Hughes, James L. (James Laughlin)	Hughes, James L. (James Laughlin)	Hughes, James L
Hutchinson, R. C. (Ray Coryton)	Hutchinson, R. C (Ray Coryton)	Hutchinson, R. C. (Ray Coryton)
Hutchinson, Horace G. (Horace Gordon)	Hutchinson, Horace G	Hutchinson, Horace G. (Horace Gordon)
Hudson, William C. (William Cadwalader)	Hudson, William C	Hudson, William C. (William Cadwalader)
Huysmans, J.-K. (Joris-Karl)	Huysmans, J.-K. (Joris-Karl)	Huysmans, J.-K (Joris-Karl)
Humphrey, Frank Pope, Mrs	Humphrey, Frank Pope	Humphrey, Frank Pope, Mrs
Hudson, Mary W. (Mary Worrell)	Hudson, Mary W	Hudson, Mary W. (Mary Worrell)
Hull, Mary H.	Hull, Mary H. [from old catalog]	Hull, Mary H
Hutchinson, A. S. M. (Arthur Stuart-Menteth)	Hutchinson, A. S. M	Hutchinson, A. S. M. (Arthur Stuart-Menteth)
Leskov, N. S. (Nikolaĭ Semenovich)	Leskov, N. S. (Nikolaĭ Semenovich)	Leskov, N. S. (Nikolaĭ Semenovich)	Leskov, N. S	Leskov, N. S (Nikolaĭ Semenovich)
Lewis, C. S. (Clive Staples)	Lewis, C. S. (Clive Staples)	Lewis, C. S (Clive Staples)
Leach, M. L. (Morgan Lewis)	Leach, M. L. (Morgan Lewis)	Leach, M. L. [from old catalog]
Le Clézio, J.-M. G. (Jean-Marie Gustave)	Le Clézio, J.-M. G (Jean-Marie Gustave)	Le Clézio, J.-M. G. (Jean-Marie Gustave)
Leadbeater, C. W. (Charles Webster)	Leadbeater, C. W. (Charles Webster)	Leadbeater, C. W (Charles Webster)
Levett Yeats, S. (Sidney)	Levett Yeats, S. (Sidney)	Levett Yeats, S
Levere, William C. (William Collin)	Levere, William C	Levere, William C. (William Collin)
Lewis, W. S. (Wilmarth Sheldon)	Lewis, W. S	Lewis, W. S. (Wilmarth Sheldon)
Lennep, J. van (Jacob van)	Lennep, J. van (Jacob)	Lennep, J. van (Jacob van)
Lee, Jennette Barbour (Perry)	Lee, Jennette Barbour Perry	Lee, Jennette Barbour (Perry)
Levner, I. B. (Israel Benjamin)	Levner, I. B (Israel Benjamin)	Levner, I. B. (Israel Benjamin)
Lee, Edna L. (Mooney)	Lee, Edna L. (Mooney)	Lee, Edna L. Mooney
Lewis, M. G. (Matthew Gregory)	Lewis, M. G	Lewis, M. G. (Matthew Gregory)
Lee, R., Mrs	Lee, R., Mrs	Lee, R, Mrs
Clouston, J. Storer (Joseph Storer)	Clouston, J. Storer (Joseph Storer)	Clouston, J. Storer
Clinkscales, J. G. (John George)	Clinkscales, J. G. (John George)	Clinkscales, J. G
Clouston, W. A. (William Alexander)	Clouston, W. A. (William Alexander)	Clouston, W. A	Clouston, W. A (William Alexander)
Clifford, Hugh Charles, Sir	Clifford, Hugh Charles, Sir	Clifford, Hugh Charles
Clark, Barrett H. (Barrett Harper)	Clark, Barrett H. (Barrett Harper)	Clark, Barrett H (Barrett Harper)
Clifford, W. K., Mrs	Clifford, W. K	Clifford, W. K, Mrs	Clifford, W. K., Mrs
Clancy, Louise Marks Breitenbach, Mrs	Clancy, Louise Marks Breitenbach, Mrs	Clancy, Louise Marks Breitenbach
Clarke, Arthur C.   (Arthur Charles)	Clarke, Arthur C (Arthur Charles)	Clarke, Arthur C.   (Arthur Charles)	Clarke, Arthur C. (Arthur Charles)
Clarke, Mary Cowden, Mrs	Clarke, Mary Cowden, Mrs	Clarke, Mary Cowden
Clark, Thomas M. (Thomas March)	Clark, Thomas M. (Thomas March)	Clark, Thomas M
Clowes, W. Laird (William Laird), Sir	Clowes, W. Laird	Clowes, W. Laird (William Laird), Sir
Clarke, Ida Clyde Gallagher, Mrs	Clarke, Ida Clyde Gallagher, Mrs	Clarke, Ida Clyde Gallagher	Clarke, Ida Clyde (Gallagher)
Judson, Emily C. (Emily Chubbuck)	Judson, Emily C. (Emily Chubbuck)	Judson, Emily C
Ebbutt, M. I. (Maud Isabel)	Ebbutt, M. I. (Maud Isabel)	Ebbutt, M. I
Eberhart, Mignon (Good), Mrs	Eberhart, Mignon Good	Eberhart, Mignon (Good), Mrs
Tarasov-Rodionov, A. (Aleksandr)	Tarasov-Rodionov, A. (Aleksandr)	Tarasov-Rodionov, A (Aleksandr)
Tarbell, Ida M. (Ida Minerva)	Tarbell, Ida M	Tarbell, Ida M (Ida Minerva)	Tarbell, Ida M. (Ida Minerva)
Talmage, T. De Witt (Thomas De Witt)	Talmage, T. De Witt (Thomas De Witt)	Talmage, T. De Witt
Tapp, Sidney C. (Sidney Calhoun)	Tapp, Sidney C	Tapp, Sidney C. (Sidney Calhoun)
Taber, Louise E. (Louise Edgar)	Taber, Louise E	Taber, Louise E. (Louise Edgar)
Gaunt, Mary (Mary Eliza Bakewell)	Gaunt, Mary (Mary Eliza Bakewell)	Gaunt, Mary Eliza Bakewell
Gardener, Helen H. (Helen Hamilton)	Gardener, Helen H	Gardener, Helen H. (Helen Hamilton)
Garstin, Denis (Denis Norman)	Garstin, Denis Norman	Garstin, Denis (Denis Norman)
Gaskell, Catherine Henrietta Milnes, Lady	Gaskell, Catherine Henrietta Milnes, Lady	Gaskell, Catherine Henrietta Milnes
Garshin, V. M. (Vsevolod Mikhaĭlovich)	Garshin, V. M. (Vsevolod Mikhaĭlovich)	Garshin, V. M. (Vsevolod Mikhaĭlovich)	Garshin, V. M (Vsevolod Mikhaı̆lovich)
Gatty, Alfred, Mrs	Gatty, Alfred, Mrs	Gatty, Alfred
Gaines, Nettie S. (Nettie Stewart)	Gaines, Nettie S	Gaines, Nettie S. (Nettie Stewart)
Gabriel, Gilbert W. (Gilbert Wolf)	Gabriel, Gilbert W	Gabriel, Gilbert W. (Gilbert Wolf)
Prodgers, C. H. (Cecil Herbert)	Prodgers, C. H	Prodgers, C. H. (Cecil Herbert)	Prodgers, C. H (Cecil Herbert)
Presser, J. (Jacob)	Presser, J. (Jacob)	Presser, J (Jacob)
Priestley, J. B. (John Boynton)	Priestley, J. B. (John Boynton)	Priestley, J. B (John Boynton)
Praed, Campbell, Mrs	Praed, Campbell	Praed, Campbell, Mrs
Prentiss, E. (Elizabeth)	Prentiss, E	Prentiss, E. (Elizabeth)
Pringle, Elizabeth W. Allston (Elizabeth Waties Allston)	Pringle, Elizabeth W. Allston (Elizabeth Waties Allston)	Pringle, Elizabeth W. Allston
Prescott, H. F. M. (Hilda Frances Margaret)	Prescott, H. F. M. (Hilda Frances Margaret)	Prescott, H. F. M (Hilda Frances Margaret)
Prince, Helen Choate (Helen Choate Pratt)	Prince, Helen Choate Pratt	Prince, Helen Choate (Pratt), Mrs	Prince, Helen Choate (Helen Choate Pratt)
Prishvin, Mikhail Mikhaĭlovich	Prishvin, Mikhail Mikhaĭlovich	Prishvin, Mikhail Mikhaĭlovich
Pratz, C. de (Claire)	Pratz, C. de	Pratz, C. de (Claire)
Pritchett, V. S. (Victor Sawdon)	Pritchett, V. S (Victor Sawdon)	Pritchett, V. S. (Victor Sawdon)
Lyle, Eugene P. (Eugene Percy)	Lyle, Eugene P. (Eugene Percy)	Lyle, Eugene P
Lyman, Olin L. (Olin Linus)	Lyman, Olin L	Lyman, Olin L. (Olin Linus)
Lyons, A. Neil (Albert Neil)	Lyons, A. Neil (Albert Neil)	Lyons, A. Neil
Lydston, G. Frank (George Frank)	Lydston, G. Frank (George Frank)	Lydston, G. Frank
Lytton, Edward Bulwer Lytton, Baron	Lytton, Edward Bulwer Lytton, Baron	Lytton, Edward Bulwer Lytton
Brooks, Charles S. (Charles Stephen)	Brooks, Charles S	Brooks, Charles S. (Charles Stephen)
Broster, D. K. (Dorothy Kathleen)	Broster, D. K. (Dorothy Kathleen)	Broster, D. K
Brown, A. E. (Abram English)	Brown, A. E (Abram English)	Brown, A. E	Brown, A. E. (Abram English)
Braddon, M. E. (Mary Elizabeth)	Braddon, M. E (Mary Elizabeth)	Braddon, M. E	Braddon, M. E. (Mary Elizabeth)
Brink, André P. (André Philippus)	Brink, André P (André Philippus)	Brink, André P. (André Philippus)
Brereton, F. S. (Frederick Sadleir)	Brereton, F. S. (Frederick Sadleir)	Brereton, F. S
Branner, H. C. (Hans Christian)	Branner, H. C. (Hans Christian)	Branner, H. C (Hans Christian)
Bronson, Wilfrid S. (Wilfrid Swancourt)	Bronson, Wilfrid S (Wilfrid Swancourt)	Bronson, Wilfrid S. (Wilfrid Swancourt)
Bruckberger, R.-L. (Raymond-Léopold)	Bruckberger, R.-L. (Raymond-Léopold)	Bruckberger, R.-L. (Raymond-Léopold)
Brown, james	Brown, james	Brown, James
Britton, Alfred Dudley	Britton, Alfred Dudley, [from old catalog]	Britton, Alfred Dudley
Bridges, John A. (John Affleck)	Bridges, John A. (John Affleck)	Bridges, John A
Brainerd, Eleanor (Hoyt), Mrs	Brainerd, Eleanor Hoyt	Brainerd, Eleanor (Hoyt), Mrs	Brainerd, Eleanor (Hoyt)
Brydges, Egerton, Sir	Brydges, Egerton	Brydges, Egerton, Sir
Bradley-Birt, F. B. (Francis Bradley)	Bradley-Birt, F. B	Bradley-Birt, F. B. (Francis Bradley)
Brooks, Elbridge S. (Elbridge Streeter)	Brooks, Elbridge S. (Elbridge Streeter)	Brooks, Elbridge S
Braithwaite, E. R. (Edward Ricardo)	Braithwaite, E. R (Edward Ricardo)	Braithwaite, E. R. (Edward Ricardo)
Brimblecom, Charles E.	Brimblecom, Charles E	Brimblecom, Charles E. [from old catalog]
Bradley, Mary E. (Mary Emily)	Bradley, Mary E	Bradley, Mary E. (Mary Emily)
Brown, H. E. (Helen E.)	Brown, H. E	Brown, H. E. (Helen E.)
Brush, Christine C. (Christine Chaplin)	Brush, Christine C	Brush, Christine C. (Christine Chaplin)
Bruce, H. Addington (Henry Addington)	Bruce, H. Addington (Henry Addington)	Bruce, H. Addington
Bradby, G. F. (Godfrey Fox)	Bradby, G. F. (Godfrey Fox)	Bradby, G. F
Brookfield, Charles H. E (Charles Hallam Elton)	Brookfield, Charles H. E	Brookfield, Charles H. E (Charles Hallam Elton)
Brock, Carey, Mrs	Brock, Carey	Brock, Carey, Mrs
Sanchez, Nellie (Van de Grift), Mrs	Sanchez, Nellie Van de Grift	Sanchez, Nellie (Van de Grift), Mrs
Sangster, Margaret E. (Margaret Elizabeth)	Sangster, Margaret E	Sangster, Margaret E. (Margaret Elizabeth)
Sampson, Mrs. Emma (Speed)	Sampson, Mrs. Emma (Speed)	Sampson, Emma Speed
Sackville-West, V. (Victoria)	Sackville-West, V. (Victoria)	Sackville-West, V	Sackville-West, V (Victoria)
Safroni-Middleton, A (Arnold)	Safroni-Middleton, A	Safroni-Middleton, A (Arnold)
Sargent, Lucius M. (Lucius Manlius)	Sargent, Lucius M	Sargent, Lucius M. (Lucius Manlius)
Sawyer, Caroline M. (Caroline Mehetabel)	Sawyer, Caroline M. (Caroline Mehetabel)	Sawyer, Caroline M
Salisbury, Harrison E. (Harrison Evans)	Salisbury, Harrison E. (Harrison Evans)	Salisbury, Harrison E (Harrison Evans)
Saint, More, Thomas, Sir	Saint, More, Thomas, Sir	Saint, More, Thomas
Sayers, Dorothy L. (Dorothy Leigh)	Sayers, Dorothy L (Dorothy Leigh)	Sayers, Dorothy L. (Dorothy Leigh)
Samuels, Edward A. (Edward Augustus)	Samuels, Edward A. (Edward Augustus)	Samuels, Edward A
Savinkov, B. V. (Boris Viktorovich)	Savinkov, B. V	Savinkov, B. V. (Boris Viktorovich)
Sawhney, S. P.	Sawhney, S P	Sawhney, S. P
Sarma, D. S. (Dittakavi Subrahmanya)	Sarma, D. S (Dittakavi Subrahmanya)	Sarma, D. S. (Dittakavi Subrahmanya)
Sanders, Charles W. (Charles Walton)	Sanders, Charles W. (Charles Walton)	Sanders, Charles W
Sabin, Edwin L. (Edwin Legrand)	Sabin, Edwin L	Sabin, Edwin L. (Edwin Legrand)
Salinger, J. D. (Jerome David)	Salinger, J. D (Jerome David)	Salinger, J. D. (Jerome David)
Sadhu, S. L. (Shyam Lal)	Sadhu, S. L (Shyam Lal)	Sadhu, S. L. (Shyam Lal)
Sawyer, Josephine Caroline	Sawyer, Josephine Caroline	Sawyer, Josephine Carolyn
Sandys, Edwyn	Sandys, Edwyn	Sandys, Edwyn. [from old catalog]
Patterson, J. H. (John Henry)	Patterson, J. H. (John Henry)	Patterson, J. H
Packard, Frank L. (Frank Lucius)	Packard, Frank L. (Frank Lucius)	Packard, Frank L
Paternoster, G. Sidney (George Sidney)	Paternoster, G. Sidney (George Sidney)	Paternoster, G. Sidney
Parker, Gilbert, Sir	Parker, Gilbert	Parker, Gilbert, Sir
Paull, H. B, Mrs	Paull, H. B	Paull, H. B, Mrs
Parmenter, Christine (Whiting), Mrs	Parmenter, Christine (Whiting), Mrs	Parmenter, Christine Whiting	Parmenter, Christine (Whiting) Mrs
Patterson, J. E. (John Edward)	Patterson, J. E	Patterson, J. E. (John Edward)
Patch, Edith M. (Edith Marion)	Patch, Edith M	Patch, Edith M. (Edith Marion)
Pattillo, T. R.	Pattillo, T R	Pattillo, T. R
Paoli, Xavier	Paoli Xavier	Paoli, Xavier
Packard, E. P. W. (Elizabeth Parsons Ware)	Packard, E. P. W	Packard, E. P. W. (Elizabeth Parsons Ware)
Paddock, A. G, Mrs	Paddock, A. G, Mrs	Paddock, A. G
Patton, Carl S. (Carl Safford)	Patton, Carl S. (Carl Safford)	Patton, Carl S (Carl Safford)
Paull, Minnie E. (Kenney)	Paull, Minnie E. Kenney	Paull, Minnie E. (Kenney)
Palangyo, Peter K. (Peter Kishili)	Palangyo, Peter K	Palangyo, Peter K. (Peter Kishili)
Paterson, A. B. (Andrew Barton)	Paterson, A. B. (Andrew Barton)	Paterson, A. B
Paton, Margaret (Whitecross)	Paton, Margaret (Whitecross)	Paton, Margaret Whitecross
Pakington, Humphrey, baron Hampton	Pakington, Humphrey, Hon	Pakington, Humphrey, baron Hampton
Yaşar, Kemal	Yaşar, Kemal	Yaşar Kemal
Wynne, Madeline (Yale), Mrs	Wynne, Madeline Yale	Wynne, Madeline (Yale), Mrs	Wynne, Madeline (Yale)
Wylie, I. A. R. (Ida Alexa Ross)	Wylie, I. A. R. (Ida Alexa Ross)	Wylie, I. A. R	Wylie, I. A. R (Ida Alexa Ross)
Wyneken, L. Ernest (Leopold Ernest)	Wyneken, L. Ernest	Wyneken, L. Ernest (Leopold Ernest)
Morgan, J. H. (John Hartman)	Morgan, J. H	Morgan, J. H. (John Hartman)
Mottram, R. H. (Ralph Hale)	Mottram, R. H. (Ralph Hale)	Mottram, R. H (Ralph Hale)
Molloy, J. Fitzgerald (Joseph Fitzgerald)	Molloy, J. Fitzgerald	Molloy, J. Fitzgerald (Joseph Fitzgerald)
Montague, C. E. (Charles Edward)	Montague, C. E. (Charles Edward)	Montague, C. E	Montague, C. E (Charles Edward)
Moore, H. J, Mrs	Moore, H. J	Moore, H. J, Mrs
Montagu, Mary Wortley, Lady	Montagu, Mary Wortley, Lady	Montagu, Mary Wortley
Morgan, Beatrice (Burton) Mrs	Morgan, Beatrice (Burton) Mrs	Morgan, Beatrice Burton
Molesworth, Mrs	Molesworth	Molesworth, Mrs
Morris, Harrison S. (Harrison Smith)	Morris, Harrison S	Morris, Harrison S. (Harrison Smith)
Montgomery, Rutherford G. (Rutherford George)	Montgomery, Rutherford George	Montgomery, Rutherford G. (Rutherford George)
Montgomery, L. M. (Lucy Maud)	Montgomery, L. M (Lucy Maud)	Montgomery, L. M	Montgomery, L. M. (Lucy Maud)
Moore, T. Sturge (Thomas Sturge)	Moore, T. Sturge (Thomas Sturge)	Moore, T. Sturge
Moffat, Edward S. (Edward Stewart)	Moffat, Edward S. (Edward Stewart)	Moffat, Edward S
Morris, I. V. (Ira Victor)	Morris, I. V. (Ira Victor)	Morris, I. V (Ira Victor)
Moore, G. Greville (George Greville)	Moore, G. Greville	Moore, G. Greville (George Greville)
More, Thomas, Sir, Saint	More, Thomas, Saint	More, Thomas, Sir, Saint
Byron-Curtiss, A. L. (Arthur Lester)	Byron-Curtiss, A. L	Byron-Curtiss, A. L. (Arthur Lester)
Byatt, A. S. (Antonia Susan)	Byatt, A. S (Antonia Susan)	Byatt, A. S. (Antonia Susan)
Byng, Lucy Margaret (Greenly) Schomberg, Mrs	Byng, Lucy Margaret (Greenly) Schomberg	Byng, Lucy Margaret (Greenly) Schomberg, Mrs
Fuller, John G. (John Grant)	Fuller, John G (John Grant)	Fuller, John G. (John Grant)
Fullerton, Georgiana Charlotte Seveson-Gower, Lady	Fullerton, Georgiana Charlotte Seveson-Gower	Fullerton, Georgiana Charlotte Seveson-Gower, Lady
Furmanov, Dm. (Dmitriĭ)	Furmanov, Dm (Dmitriĭ)	Furmanov, Dm. (Dmitriĭ)	Furmanov, Dm. (Dmitriĭ)
Fullerton, Hugh S. (Hugh Stuart)	Fullerton, Hugh S	Fullerton, Hugh S. (Hugh Stuart)
Fuessle, Newton A. (Newton Augustus)	Fuessle, Newton A	Fuessle, Newton A. (Newton Augustus)
Myers, L. H. (Leopold Hamilton)	Myers, L. H. (Leopold Hamilton)	Myers, L. H (Leopold Hamilton)
Myers, P. Hamilton (Peter Hamilton)	Myers, P. Hamilton	Myers, P. Hamilton (Peter Hamilton)
Yeats, W. B. (William Butler)	Yeats, W. B (William Butler)	Yeats, W. B. (William Butler)	Yeats, W. B
Uttley, Alison, Mrs	Uttley, Alison, Mrs	Uttley, Alison
Pierce, Gilbert A. (Gilbert Ashville)	Pierce, Gilbert A. (Gilbert Ashville)	Pierce, Gilbert A
Pieyre de Mandiargues, André	Pieyre de Mandiargues, André	Pieyre de Mandiargues, André
Pinkerton, Kathrene Sutherland (Gedney)	Pinkerton, Kathrene Sutherland (Gedney)	Pinkerton, Kathrene Sutherland Gedney
Pisemskiĭ, A. F. (Alekseĭ Feofilaktovich)	Pisemskiĭ, A. F. (Alekseĭ Feofilaktovich)	Pisemskiĭ, A. F (Alekseĭ Feofilaktovich)
Pierce, Ruth, Mrs	Pierce, Ruth, Mrs	Pierce, Ruth
Oliphant, Mrs. (Margaret)	Oliphant, Mrs. (Margaret)	Oliphant, (Margaret), Mrs
Goodwin, H. B. (Hannah Bradbury)	Goodwin, H. B	Goodwin, H. B. (Hannah Bradbury)
Gorgas, Annie Gaskin (Stewart)	Gorgas, Annie Gaskin Stewart	Gorgas, Annie Gaskin (Stewart)
Gore, J. Rogers (John Rogers)	Gore, J. Rogers	Gore, J. Rogers (John Rogers)
Gorbatov, Boris Leontʹevich	Gorbatov, Boris Leontʹevich	Gorbatov, Boris Leontevich
Goff, H. N. K. (Harriet Newell Kneeland)	Goff, H. N. K. (Harriet Newell Kneeland)	Goff, H. N. K
Goodwin, Maud Wilder, Mrs	Goodwin, Maud Wilder, Mrs	Goodwin, Maud Wilder
Goodrich, Samuel G. (Samuel Griswold)	Goodrich, Samuel G	Goodrich, Samuel G. (Samuel Griswold)
Gowen, Herbert H. (Herbert Henry)	Gowen, Herbert H. (Herbert Henry)	Gowen, Herbert H (Herbert Henry)
Goodwin, C. C. (Charles Carroll)	Goodwin, C. C. (Charles Carroll)	Goodwin, C. C
Kinkaid, Mary Holland (McNeish), Mrs	Kinkaid, Mary Holland McNeish	Kinkaid, Mary Holland (McNeish), Mrs
Kirkland, Caroline M. (Caroline Matilda)	Kirkland, Caroline M	Kirkland, Caroline M (Caroline Matilda)	Kirkland, Caroline M. (Caroline Matilda)
Kingsley, Florence (Morse), Mrs	Kingsley, Florence Morse	Kingsley, Florence (Morse)	Kingsley, Florence (Morse), Mrs	Kingsley, Florence Morse, Mrs
Kincaid, C. A. (Charles Augustus)	Kincaid, C. A	Kincaid, C. A. (Charles Augustus)
Kimball, Richard B. (Richard Burleigh)	Kimball, Richard B	Kimball, Richard B. (Richard Burleigh)
Kimball, James Newton	Kimball, James Newton	Kimball, James Newton. [from old catalog]
Kinzie, John H., Mrs	Kinzie, John H, Mrs	Kinzie, John H., Mrs	Kinzie, John H
Fosdick, W. W. (William Whiteman)	Fosdick, W. W. (William Whiteman)	Fosdick, W. W
Fortescue, J. W. (John William), Sir	Fortescue, J. W. (John William), Sir	Fortescue, J. W
Fowler, W. Warde (William Warde)	Fowler, W. Warde (William Warde)	Fowler, W. Warde
Forster, E. M. (Edward Morgan)	Forster, E. M. (Edward Morgan)	Forster, E. M (Edward Morgan)
Foster, R. F. (Robert Frederick)	Foster, R. F	Foster, R. F. (Robert Frederick)
Foote, Mary (Hallock), Mrs	Foote, Mary (Hallock), Mrs	Foote, Mary Hallock
Forester, C. S. (Cecil Scott)	Forester, C. S. (Cecil Scott)	Forester, C. S (Cecil Scott)
Foster, Charles J. (Charles James)	Foster, Charles J	Foster, Charles J. (Charles James)
Fowler, Nathaniel C. (Nathaniel Clark)	Fowler, Nathaniel C. (Nathaniel Clark)	Fowler, Nathaniel C
baroness, Calabrella, E. C. de	baroness, Calabrella, E. C. de	baroness Calabrella, E. C. de
baron de, Lamothe-Langon, Étienne Léon	baron de, Lamothe-Langon, Étienne Léon	baron de, Lamothe-Langon, Étienne Léon	baron de, Lamothe-Langon, Etienne-Léon
baronne, Aimery de Pierrebourg, Marguerite (Thomas-Galline)	baronne, Aimery de Pierrebourg, Marguerite Thomas-Galline	baronne, Aimery de Pierrebourg, Marguerite (Thomas-Galline)
Atkinson, Eleanor (Stockhouse), Mrs	Atkinson, Eleanor (Stackhouse)	Atkinson, Mrs. Eleanor Stackhouse	Atkinson, Eleanor (Stockhouse), Mrs	Atkinson, Eleanor (Stackhouse), Mrs
Atkinson, J. C. (John Christopher)	Atkinson, J. C	Atkinson, J. C. (John Christopher)
Jerome, Jerome K. (Jerome Klapka)	Jerome, Jerome K (Jerome Klapka)	Jerome, Jerome K	Jerome, Jerome K. (Jerome Klapka)
Jefferson, Robert L. (Robert Louis)	Jefferson, Robert L	Jefferson, Robert L. (Robert Louis)
Jensen, Johannes V. (Johannes Vilhelm)	Jensen, Johannes V (Johannes Vilhelm)	Jensen, Johannes V. (Johannes Vilhelm)
Jelliffe, Belinda Dobson, Mrs	Jelliffe, Belinda Dobson	Jelliffe, Belinda Dobson, Mrs
Jenkin, C. (Camilla)	Jenkin, C. (Camilla)	Jenkin, C, Mrs	Jenkin, C
Jennings, John A. (John Andrew)	Jennings, John A. (John Andrew)	Jennings, John A
Jesse, F. Tennyson (Fryniwyd Tennyson)	Jesse, F. Tennyson (Fryniwyd Tennyson)	Jesse, F. Tennyson
Ryan, P. F. William (Patrick Francis William)	Ryan, P. F. William (Patrick Francis William)	Ryan, P. F. William	Ryan, P.F. William
Plympton, A. G. (Almira George)	Plympton, A. G	Plympton, A. G. (Almira George)
Plaatje, Sol. T. (Solomon Tshekisho)	Plaatje, Sol. T. (Solomon Tshekisho)	Plaatje, Sol. T (Solomon Tshekisho)
Gilbreth, Frank B. (Frank Bunker)	Gilbreth, Frank B. (Frank Bunker)	Gilbreth, Frank B (Frank Bunker)
Gilmore, James R. (James Roberts)	Gilmore, James R. (James Roberts)	Gilmore, James R
Gilliam, E. W. (Edward Winslow)	Gilliam, E. W	Gilliam, E. W. (Edward Winslow)
Gibbs, A. Hamilton (Arthur Hamilton)	Gibbs, A. Hamilton (Arthur Hamilton)	Gibbs, A. Hamilton
Gilbert, W. S. (William Schwenck)	Gilbert, W. S. (William Schwenck)	Gilbert, W. S
Gillie, R. C. (Robert Calder)	Gillie, R. C. (Robert Calder)	Gillie, R. C
Gilman, Caroline (Howard)	Gilman, Caroline Howard	Gilman, Caroline (Howard)
Gibson, Charles B. (Charles Bernard)	Gibson, Charles B	Gibson, Charles B. (Charles Bernard)
Gielow, Martha S. (Martha Sawyer)	Gielow, Martha S	Gielow, Martha S. (Martha Sawyer)
Gilder, Jeannette L. (Jeannette Leonard)	Gilder, Jeannette L	Gilder, Jeannette L. (Jeannette Leonard)
Dorsey, George A. (George Amos)	Dorsey, George A (George Amos)	Dorsey, George A. (George Amos)	Dorsey, George A
Douglas, Lloyd C. (Lloyd Cassel)	Douglas, Lloyd C. (Lloyd Cassel)	Douglas, Lloyd C (Lloyd Cassel)
Downing, Margaret B. (Margaret Brent)	Downing, Margaret B. (Margaret Brent)	Downing, Margaret B (Margaret Brent)
Doyle, Arthur Conan, Sir	Doyle, Arthur Conan, Sir	Doyle, Arthur Conan
Doty, Madeleine Z. (Madeleine Zabriskie)	Doty, Madeleine Z. (Madeleine Zabriskie)	Doty, Madeleine Z
Donleavy, J. P. (James Patrick)	Donleavy, J. P. (James Patrick)	Donleavy, J. P (James Patrick)
Dougall, L. (Lily)	Dougall, L. (Lily)	Dougall, L (Lily)
Dorrance, Ethel Arnold Smith, Mrs	Dorrance, Ethel Arnold Smith, Mrs	Dorrance, Ethel Arnold Smith
Douglas, Robert K. (Robert Kennaway), Sir	Douglas, Robert K	Douglas, Robert K. (Robert Kennaway), Sir
Doyle, C. W. (Charles William)	Doyle, C. W	Doyle, C. W. (Charles William)
Donovan, Frances R, Mrs	Donovan, Frances R	Donovan, Frances R, Mrs
Johnstone, C. I. (Christian Isobel)	Johnstone, C. I	Johnstone, C. I. (Christian Isobel)
Johnston, Annie F. (Annie Fellows)	Johnston, Annie F (Annie Fellows)	Johnston, Annie F. (Annie Fellows)	Johnston, Annie F
Johnston, W. J. (William John)	Johnston, W. J	Johnston, W. J. (William John)
Johnston, J. P. (James Perry)	Johnston, J. P. (James Perry)	Johnston, J. P
Jones, J. B. (John Beauchamp)	Jones, J. B. (John Beauchamp)	Jones, J. B
Jones, Henry, Sir	Jones, Henry	Jones, Henry, Sir
Joshi, V. K. (Virendra Kumar)	Joshi, V. K. (Virendra Kumar)	Joshi, V. K (Virendra Kumar)
Jones, T. E. (Theodore Eldon)	Jones, T. E	Jones, T. E. (Theodore Eldon)
Joyce, P. W. (Patrick Weston)	Joyce, P. W	Joyce, P. W. (Patrick Weston)
Johnson, Charles (Charles Richard)	Johnson, Charles (Charles Richard)	Johnson, Charles Richard
Otis, Harrison Gray, Mrs	Otis, Harrison Gray	Otis, Harrison Gray, Mrs
Trowbridge, W. R. H. (William Rutherford Hayes)	Trowbridge, W. R. H. (William Rutherford Hayes)	Trowbridge, W. R. H
Trevelyan, L. R, Mrs	Trevelyan, L. R	Trevelyan, L. R, Mrs
Trevelyan, George Otto, Sir	Trevelyan, George Otto, Sir	Trevelyan, George Otto
Trowbridge, J. T. (John Townsend)	Trowbridge, J. T. (John Townsend)	Trowbridge, J. T
Short, Raymond W. (Raymond Wright)	Short, Raymond W (Raymond Wright)	Short, Raymond W. (Raymond Wright)
Sharber, Kate Trimble, Mrs	Sharber, Kate Trimble, Mrs	Sharber, Kate Trimble
Sheringham, H. T. (Hugh Tempest)	Sheringham, H. T	Sheringham, H. T. (Hugh Tempest)
Shillaber, B. P. (Benjamin Penhallow)	Shillaber, B. P. (Benjamin Penhallow)	Shillaber, B. P
Shiel, M. P. (Matthew Phipps)	Shiel, M. P. (Matthew Phipps)	Shiel, M. P	Shiel, M. P (Matthew Phipps)
Shoemaker, Henry W. (Henry Wharton)	Shoemaker, Henry W (Henry Wharton)	Shoemaker, Henry W. (Henry Wharton)	Shoemaker, Henry W
Sherriff, R. C. (Robert Cedric)	Sherriff, R. C (Robert Cedric)	Sherriff, R. C. (Robert Cedric)
Sheldon, Georgie, Mrs	Sheldon, Georgie, Mrs	Sheldon, Georgie
Shriner, Charles A. (Charles Anthony)	Shriner, Charles A	Shriner, Charles A. (Charles Anthony)
Shepherd, William G. (William Gunn)	Shepherd, William G. (William Gunn)	Shepherd, William G
Sherwood, (Mary Martha), 1775-1851, Mrs	Sherwood, (Mary Martha), Mrs	Sherwood, (Mary Martha), 1775-1851, Mrs	Sherwood, Mary Martha
Shioya, Sakae	Shioya, Sakae. [from old catalog]	Shioya, Sakae
Shorthouse, J. H. (Joseph Henry)	Shorthouse, J. H	Shorthouse, J.H	Shorthouse, J. H. (Joseph Henry)	Shorthouse, J. H (Joseph Henry)
Shishkov, V. I͡A. (Vi͡acheslav I͡Akovlevich)	Shishkov, V. I͡A. (Vi͡acheslav I͡Akovlevich)	Shishkov, V. I͡A (Vi͡acheslav I͡Akovlevich)
Shafer, Sara Andrew, Mrs	Shafer, Sara Andrew	Shafer, Sara Andrew, Mrs
Shelton, F. W. (Frederick William)	Shelton, F. W	Shelton, F. W. (Frederick William)
Shute, Henry A. (Henry Augustus)	Shute, Henry A	Shute, Henry A. (Henry Augustus)	Shute, Henry A (Henry Augustus)
Sherwood, M. E. W. (Mary Elizabeth Wilson)	Sherwood, M. E. W	Sherwood, M. E. W. (Mary Elizabeth Wilson)
Shedd, George C. (George Clifford)	Shedd, George C. (George Clifford)	Shedd, George C
Shaw, Edward R (Edward Richard)	Shaw, Edward R (Edward Richard)	Shaw, Edward R
Shoemaker, Charles C. (Charles Chalmers)	Shoemaker, Charles C	Shoemaker, Charles C. (Charles Chalmers)
Shawmeker, Harvey	Shawmeker, Harvey. [from old catalog]	Shawmeker, Harvey
Ravage, M. E. (Marcus Eli)	Ravage, M. E (Marcus Eli)	Ravage, M. E. (Marcus Eli)	Ravage, M. E
Rattray, R. S. (Robert Sutherland)	Rattray, R. S. (Robert Sutherland)	Rattray, R. S (Robert Sutherland)
Rafy, K U, Mrs	Rafy, K U	Rafy, K U, Mrs
Ramsay, Robert L., (Robert Lee)	Ramsay, Robert L	Ramsay, Robert L., (Robert Lee)
Racovița, Elena (von Dönniges)	Racovița, Elena (von Dönniges)	Racovița, Elena (von Dönniges)
Rand, Edward A. (Edward Augustus)	Rand, Edward A. (Edward Augustus)	Rand, Edward A
Rak, Mary Kidder, Mrs	Rak, Mary Kidder, Mrs	Rak, Mary Kidder
Rawnsley, H. D. (Hardwicke Drummond)	Rawnsley, H. D. (Hardwicke Drummond)	Rawnsley, H. D
Ramuz, C. F. (Charles Ferdinand)	Ramuz, C. F. (Charles Ferdinand)	Ramuz, C. F (Charles Ferdinand)
Ramarau, Rama V. M. G.	Ramarau, Rama V M G	Ramarau, Rama V. M. G
Raj Rao, R. (Ramachandrapurapu)	Raj Rao, R. (Ramachandrapurapu)	Raj Rao, R (Ramachandrapurapu)
Lovecraft, H. P. (Howard Phillips)	Lovecraft, H. P (Howard Phillips)	Lovecraft, H. P. (Howard Phillips)
Long, William J. (William Joseph)	Long, William J	Long, William J. (William Joseph)
Lockwood, Frank, Sir	Lockwood, Frank	Lockwood, Frank, Sir
Lodge, James, Mrs	Lodge, James	Lodge, James, Mrs
Lockhart, J. G. (John Gibson)	Lockhart, J. G. (John Gibson)	Lockhart, J. G
Loch, Joice Nankivell	Loch, Joice Nankivell	Loch, Joice NanKivell
Lowenberg, I., Mrs	Lowenberg, I., Mrs	Lowenberg, I, Mrs
Voynich, E. L. (Ethel Lillian)	Voynich, E. L	Voynich, E. L. (Ethel Lillian)
Van Vogt, A. E. (Alfred Elton)	Van Vogt, A. E. (Alfred Elton)	Van Vogt, A. E (Alfred Elton)
Vandercook, John W. (John Womack)	Vandercook, John W (John Womack)	Vandercook, John W. (John Womack)
Van de Water, Virginia Belle (Terhune)	Van de Water, Virginia Belle (Terhune)	Van de Water, Virginia Terhune
Van den Heever, C. M. (Christiaan Maurits)	Van den Heever, C. M. (Christiaan Maurits)	Van den Heever, C. M (Christiaan Maurits)
Vaizey, George de Horne, Mrs	Vaizey, George de Horne, Mrs	Vaizey, George de Horne
Van Dyke, Theodore S. (Theodore Strong)	Van Dyke, Theodore S	Van Dyke, Theodore S. (Theodore Strong)
Van Zile, Edward S. (Edward Sims)	Van Zile, Edward S	Van Zile, Edward S. (Edward Sims)
Crosland, Newton, Mrs	Crosland, Newton	Crosland, Newton, Mrs
Crockett, S. R. (Samuel Rutherford)	Crockett, S. R	Crockett, S. R. (Samuel Rutherford)
Crawford, F. Marion (Francis Marion)	Crawford, F. Marion	Crawford, F. Marion (Francis Marion)
Cruz, Roman A. de la	Cruz, Roman A. de la	Cruz, Roman A de la
Crawford, M. MacDermot (Mary MacDermot)	Crawford, M. MacDermot (Mary MacDermot)	Crawford, M. MacDermot
Craik, Georgiana M. (Georgiana Marion)	Craik, Georgiana M. (Georgiana Marion)	Craik, Georgiana M
Crumpton, H. J. (Hezekiah John)	Crumpton, H. J	Crumpton, H. J. (Hezekiah John)
Croker, B. M. (Bithia Mary)	Croker, B. M. (Bithia Mary)	Croker, B. M
Crandall, Lathan A. (Lathan Augustus)	Crandall, Lathan A. (Lathan Augustus)	Crandall, Lathan A
Crowninshield, Schuyler, Mrs	Crowninshield, Schuyler	Crowninshield, Schuyler, Mrs
Craik, Dinah Maria (Mulock), Mrs	Craik, Dinah Maria Mulock	Craik, Dinah Maria (Mulock), Mrs
Crake, A. D. (Augustine David)	Crake, A. D. (Augustine David)	Crake, A. D
Cronin, A. J. (Archibald Joseph)	Cronin, A. J. (Archibald Joseph)	Cronin, A. J (Archibald Joseph)
Creyke, Walter, Mrs	Creyke, Walter, Mrs	Creyke, Walter
Crawford, Lucy, Mrs	Crawford, Lucy	Crawford, Lucy, Mrs
Tiernan, Frances Christine (Fisher), Mrs	Tiernan, Frances Christine (Fisher)	Tiernan, Frances Christine (Fisher), Mrs
Sullivan, May Kellogg, Mrs	Sullivan, May Kellogg	Sullivan, May Kellogg, Mrs
Sulzberger, C. L. (Cyrus Leo)	Sulzberger, C. L. (Cyrus Leo)	Sulzberger, C. L (Cyrus Leo)
Summers, Florence Elizabeth	Summers, Florence Elizabeth	Summers, Florence Elizabeth. [from old catalog]
Arthur, T. S. (Timothy Shay)	Arthur, T. S	Arthur, T. S (Timothy Shay)	Arthur, T. S. (Timothy Shay)
Art︠s︡ybashev, M. (Mikhail)	Art︠s︡ybashev, M. (Mikhail)	Art︠s︡ybashev, M (Mikhail)
Arnold, Edwin Lester Londen	Arnold, Edwin Lester Londen	Arnold, Edwin Lester Linden
Art͡sybashev, M. (Mikhail)	Art͡sybashev, M. (Mikhail)	Art͡sybashev, M (Mikhail)
Glascock, W. N. (William Nugent)	Glascock, W. N. (William Nugent)	Glascock, W. N
Gleig, G. R. (George Robert)	Gleig, G. R. (George Robert)	Gleig, G. R
G. S. Lee,, Lee, Jennette Barbour (Perry), Mrs	G. S. Lee, Lee, Jennette Barbour Perry, Mrs	G. S. Lee, Lee, Jennette Barbour (Perry), Mrs	G. S. Lee,, Lee, Jennette Barbour (Perry), Mrs
Orton, J. R. (Jason Rockwood)	Orton, J. R	Orton, J. R. (Jason Rockwood)
Young, Laura DeHart	Young, Laura DeHart	Young, Laura Dehart
Yonge, Charlotte M. (Charlotte Mary)	Yonge, Charlotte M. (Charlotte Mary)	Yonge, Charlotte M	Yonge, Charlotte M (Charlotte Mary)
Young, E. H. (Emily Hilda)	Young, E. H (Emily Hilda)	Young, E. H. (Emily Hilda)
Davies, W. H. (William Henry)	Davies, W. H. (William Henry)	Davies, W. H
Davis, M. E. M. (Mollie Evelyn Moore)	Davis, M. E. M. (Mollie Evelyn Moore)	Davis, M. E. M
Davis, J. Frank, (James Francis)	Davis, J. Frank, (James Francis)	Davis, J. Frank (James Francis)
Dasent, George Webbe, Sir	Dasent, George Webbe, Sir	Dasent, George Webbe
Daniels, Mabel W. (Mabel Wheeler)	Daniels, Mabel W	Daniels, Mabel W. (Mabel Wheeler)
Daggett, Mary (Stewart), Mrs	Daggett, Mary (Stewart), Mrs	Daggett, Mary (Stewart)
Davies, E. Chivers (Ellen Chivers)	Davies, E. Chivers (Ellen Chivers)	Davies, E. Chivers
Dallas, Mary (Kyle)	Dallas, Mary (Kyle)	Dallas, Mary Kyle
Dawson, W. J. (William James)	Dawson, W. J	Dawson, W. J. (William James)	Dawson, W. J (William James)
Davis, Edith (Smith)	Davis, Edith Smith	Davis, Edith (Smith)
Darton, F. J. Harvey (Frederick Joseph Harvey)	Darton, F. J. Harvey (Frederick Joseph Harvey)	Darton, F. J. Harvey
Mann, Mary E., (Rackham) | Mrs	Mann, Mary E., (Rackham)	Mann, Mary E., (Rackham) | Mrs
Madame de La Fayette, (Marie-Madeleine Pioche de La Vergne)	Madame de La Fayette, (Marie-Madeleine Pioche de La Vergne)	Madame de (Marie-Madeleine Pioche de La Vergne), La Fayette
Maxwell, Ellen (Blackmar)	Maxwell, Ellen (Blackmar)	Maxwell, Ellen Blackmar
Mallock, W. H. (William Hurrell)	Mallock, W. H	Mallock, W. H. (William Hurrell)	Mallock, W. H (William Hurrell)
Mackay, Helen, Mrs	Mackay, Helen	Mackay, Helen, Mrs
Marquand, John P. (John Phillips)	Marquand, John P (John Phillips)	Marquand, John P	Marquand, John P. (John Phillips)
Mayor, F. M. (Flora Macdonald)	Mayor, F. M	Mayor, F. M. (Flora Macdonald)
Mackay, Isabel Ecclestone (Macpherson), Mrs	Mackay, Isabel Ecclestone	Mackay, Isabel Ecclestone (Macpherson)	Mackay, Isabel Ecclestone (Macpherson), Mrs
Mannix, Daniel P. (Daniel Pratt)	Mannix, Daniel P. (Daniel Pratt)	Mannix, Daniel P (Daniel Pratt)
Mason, Catherine George (Ward), Mrs	Mason, Catherine George (Ward)	Mason, Catherine George (Ward), Mrs
Manley, (Mary de la Rivière), Mrs	Manley, (Mary de la Rivière), Mrs	Manley, (Mary de la Rivière), Mrs	Manley, Mrs. (Mary de la Rivière)
Mason, A. E. W. (Alfred Edward Woodley)	Mason, A. E. W. (Alfred Edward Woodley)	Mason, A. E. W
Madame d' Aulnoy, (Marie-Catherine)	Madame d' Aulnoy, (Marie-Catherine)	Madame d' (Marie-Catherine), Aulnoy
Marshall, S. L. A. (Samuel Lyman Atwood)	Marshall, S. L. A. (Samuel Lyman Atwood)	Marshall, S. L. A (Samuel Lyman Atwood)
Mackenzie, Compton, Sir	Mackenzie, Compton	Mackenzie, Compton, Sir
Macquoid, Katharine S. (Katharine Sarah)	Macquoid, Katharine S. (Katharine Sarah)	Macquoid, Katharine Sarah (Gadsden), Mrs
Maxwell, W. H. (William Hamilton)	Maxwell, W. H. (William Hamilton)	Maxwell, W. H
Mackenzie, R. Shelton (Robert Shelton)	Mackenzie, R. Shelton	Mackenzie, R. Shelton (Robert Shelton)
Martin, George (Madden), Mrs	Martin, George Madden	Martin, George (Madden)	Martin, George (Madden), Mrs
Markham, Clements R. (Clements Robert), Sir	Markham, Clements R. (Clements Robert), Sir	Markham, Clements R
Martin du Gard, Roger	Martin du Gard, Roger	Martin Du Gard, Roger
Mackail, J. W. (John William)	Mackail, J. W (John William)	Mackail, J. W	Mackail, J. W. (John William)
Mason, Catherine George Ward, Mrs	Mason, Catherine George Ward	Mason, Catherine George Ward, Mrs
Martin, Frank E. (Frank Eugene)	Martin, Frank E. (Frank Eugene)	Martin, Frank E
Margueritte, V. (Victor)	Margueritte, V. (Victor)	Margueritte, V
Marlitt, E. (Eugenie)	Marlitt, E (Eugenie)	Marlitt, E	Marlitt, E. (Eugenie)
Matz, B. W. (Bertram Waldrom)	Matz, B. W. (Bertram Waldrom)	Matz, B. W
Matthews, Caroline Twigge, Mrs	Matthews, Caroline Twigge, Mrs	Matthews, Caroline Twigge
Marvel, Ik	Marvel Ik	Marvel, Ik
Macchetta, Blanche Roosevelt Tucker, Mrs	Macchetta, Blanche Roosevelt Tucker	Macchetta, Blanche Roosevelt Tucker, Mrs
MacGregor, Mary Esther (Millier), Mrs	MacGregor, Mary Esther (Millier), Mrs	MacGregor, Mary Esther Miller
Manners-Sutton, D. (Doris)	Manners-Sutton, D. (Doris)	Manners-Sutton, D
Mason, Caroline (Atwater)	Mason, Caroline (Atwater)	Mason, Caroline Atwater
Marshall, Emma, Mrs	Marshall, Emma	Marshall, Emma, Mrs
Maugham, W. Somerset, (William Somerset)	Maugham, W. Somerset, (William Somerset)	Maugham, W. Somerset (William Somerset)	Maugham, W. Somerset
Maxwell, Mary Elizabeth (Braddon), Mrs	Maxwell, Mary Elizabeth (Braddon), Mrs	Maxwell, Mary Elizabeth (Braddon)
Maxwell, W. B. (William Babington)	Maxwell, W. B. (William Babington)	Maxwell, W. B
Malory, Thomas, Sir	Malory, Thomas, Sir	Malory, Thomas
Manhood, H. A. (Harold Alfred)	Manhood, H. A. (Harold Alfred)	Manhood, H. A (Harold Alfred)
Mayo, Isabella (Fyvie)	Mayo, Isabella Fyvie	Mayo, Isabella (Fyvie)
Marsh, H. P (Horace Pierce)	Marsh, H. P	Marsh, H. P (Horace Pierce)
Mackenzie, Donald A. (Donald Alexander)	Mackenzie, Donald A (Donald Alexander)	Mackenzie, Donald A. (Donald Alexander)
Major Richardson, (John)	Major Richardson, (John)	Major (John), Richardson
Marchmont, Arthur W. (Arthur Williams)	Marchmont, Arthur W. (Arthur Williams)	Marchmont, Arthur W
Macdonnell, J. E. (James Edmond)	Macdonnell, J. E (James Edmond)	Macdonnell, J. E. (James Edmond)
Mason, Benjamin F. (Benjamin Franklin)	Mason, Benjamin F. (Benjamin Franklin)	Mason, Benjamin F
Malcolm, John, Sir	Malcolm, John, Sir	Malcolm, John
Macnaughtan, S. (Sarah)	Macnaughtan, S. (Sarah)	Macnaughtan, S
Allen, William, Mrs	Allen, William	Allen, William, Mrs
Alden, W. L. (William Livingston)	Alden, W. L. (William Livingston)	Alden, W. L
Almedingen, E. M. (Edith Martha)	Almedingen, E. M. (Edith Martha)	Almedingen, E. M (Edith Martha)
Allinson, Anne Crosby (Emery), Mrs	Allinson, Anne Crosby Emery	Allinson, Anne Crosby (Emery), Mrs
Alger, Abby L. (Abby Langdon)	Alger, Abby L. (Abby Langdon)	Alger, Abby L
Alvarez, A. (Alfred)	Alvarez, A. (Alfred)	Alvarez, A (Alfred)
Almqvist, C. J. L. (Carl Jonas Love)	Almqvist, C. J. L (Carl Jonas Love)	Almqvist, C. J. L. (Carl Jonas Love)
Altsheler, Joseph A. (Joseph Alexander)	Altsheler, Joseph A	Altsheler, Joseph A. (Joseph Alexander)
Allee, Marjorie (Hill), Mrs	Allee, Marjorie Hill	Allee, Marjorie (Hill), Mrs
Alexander, Louis C. (Louis Charles)	Alexander, Louis C	Alexander, Louis C. (Louis Charles)
Alexander, Mrs	Alexander	Alexander, Mrs
Aldrich, Mildred	Aldrich, Mildred	Aldrich, Mildred. [from old catalog]
Smith, Alice Prescott, Mrs	Smith, Alice Prescott, Mrs	Smith, Alice Prescott
Smedley, Frank E. (Frank Edward)	Smedley, Frank E	Smedley, Frank E. (Frank Edward)
Smith, Harriet L. (Harriet Lummis)	Smith, Harriet L. (Harriet Lummis)	Smith, Harriet L
Smith, C. W. (Charles William)	Smith, C. W (Charles William)	Smith, C. W. (Charles William)
Smythies, Gordon, Mrs	Smythies, Gordon, Mrs	Smythies, Gordon
Smith, W. L. G. (William L. G.)	Smith, W. L. G. (William L. G.)	Smith, W. L. G
Smollett, T. (Tobias)	Smollett, T	Smollett, T. (Tobias)
Nyburg, Sidney L. (Sidney Lauer)	Nyburg, Sidney L. (Sidney Lauer)	Nyburg, Sidney L
Landis, Simon M. (Simon Mohler)	Landis, Simon M. (Simon Mohler)	Landis, Simon M
Latta, Robert R. (Robert Ray)	Latta, Robert R. (Robert Ray)	Latta, Robert R (Robert Ray)
Lauder, Maria Elise Turner, Mrs	Lauder, Maria Elise Turner	Lauder, Maria Elise Turner, Mrs
Lawrence, Henry Montgomery, Sir	Lawrence, Henry Montgomery	Lawrence, Henry Montgomery, Sir
Laing, Hamilton M. (Hamilton Mack)	Laing, Hamilton M. (Hamilton Mack)	Laing, Hamilton M
Lawrence, D. H. (David Herbert)	Lawrence, D. H (David Herbert)	Lawrence, D. H. (David Herbert)	Lawrence, D. H
Lawson, Alfred W. (Alfred William)	Lawson, Alfred W	Lawson, Alfred W. (Alfred William)
Laut, Agnes C. (Agnes Christina)	Laut, Agnes C. (Agnes Christina)	Laut, Agnes C
Lawrence, George A. (George Alfred)	Lawrence, George A	Lawrence, George A. (George Alfred)
Laughlin, Clara E. (Clara Elizabeth)	Laughlin, Clara E	Laughlin, Clara E. (Clara Elizabeth)
La Fayette, (Marie-Madeleine Pioche de La Vergne), Madame de	La Fayette, Madame de (Marie-Madeleine Pioche de La Vergne)	La Fayette, (Marie-Madeleine Pioche de La Vergne), Madame de
Lamson, Mary (Swift), Mrs	Lamson, Mary (Swift), Mrs	Lamson, Mary Swift	Lamson, Mary (Swift)
Lathrop, George Parsons, 1851-1898	Lathrop, George Parsons	Lathrop, George Parsons, 1851-1898
Lauder, Harry, Sir	Lauder, Harry	Lauder, Harry, Sir
Skinner, B. F. (Burrhus Frederic)	Skinner, B. F. (Burrhus Frederic)	Skinner, B. F (Burrhus Frederic)
Skinner, Charles M. (Charles Montgomery)	Skinner, Charles M	Skinner, Charles M. (Charles Montgomery)
Skelton, John, Sir	Skelton, John	Skelton, John, Sir
Skinner, Ada M. (Ada Maria)	Skinner, Ada M. (Ada Maria)	Skinner, Ada M
Twombly, Alexander S. (Alexander Stevenson)	Twombly, Alexander S. (Alexander Stevenson)	Twombly, Alexander S (Alexander Stevenson)
Hoover, Francis T. (Francis Trout)	Hoover, Francis T. (Francis Trout)	Hoover, Francis T
Howe, W. H. (Walter Henry)	Howe, W. H. (Walter Henry)	Howe, W. H
Horne, R. H. (Richard H.)	Horne, R. H	Horne, R. H. (Richard H.)
Hope, Edward Hope	Hope, Edward	Hope, Edward Hope
Holmes, Richard S. (Richard Sill)	Holmes, Richard S	Holmes, Richard S. (Richard Sill)
Hough, S. B. (Stanley Bennett)	Hough, S. B. (Stanley Bennett)	Hough, S. B (Stanley Bennett)
Hoffmann, E. T. A. (Ernst Theodor Amadeus)	Hoffmann, E. T. A. (Ernst Theodor Amadeus)	Hoffmann, E. T. A (Ernst Theodor Amadeus)
Horlock, Knightley William	Horlock, Knightley Willia	Horlock, Knightley William
Howard, M. W. (Milford Wriarson)	Howard, M. W. (Milford Wriarson)	Howard, M. W
Howe, E. W. (Edgar Watson)	Howe, E. W	Howe, E. W. (Edgar Watson)
Hobart, Alice Tisdale Nourse, Mrs	Hobart, Alice Tisdale Nourse, Mrs	Hobart, Alice Tisdale Nourse	Hobart, Alice Tisdale
Howe, Sonia E. (Sonia Elizabeth)	Howe, Sonia E. (Sonia Elizabeth)	Howe, Sonia E (Sonia Elizabeth)
Holland, J. G. (Josiah Gilbert)	Holland, J. G	Holland, J. G. (Josiah Gilbert)
Hobart, George V. (George Vere)	Hobart, George V. (George Vere)	Hobart, George V
Holmes, Robert Derby	Holmes, Robert Derby. [from old catalog]	Holmes, Robert Derby
Hodgetts, J. Frederick (James Frederick)	Hodgetts, J. Frederick (James Frederick)	Hodgetts, J. Frederick
Howe, Maud Howe, Mrs	Howe, Maud	Howe, Maud Howe, Mrs
Hornung, E. W. (Ernest William)	Hornung, E. W. (Ernest William)	Hornung, E. W
Hoopes, Mary Howard (Peterson), Mrs	Hoopes, Mary Howard (Peterson)	Hoopes, Mary Howard (Peterson), Mrs
Hotchkiss, Chauncey C. (Chauncey Crafts)	Hotchkiss, Chauncey C. (Chauncey Crafts)	Hotchkiss, Chauncey Crafts
Hoyle, Fred, Sir	Hoyle, Fred, Sir	Hoyle, Fred
Hodgetts, E. A. Brayley (Edward Arthur Brayley)	Hodgetts, E. A. Brayley (Edward Arthur Brayley)	Hodgetts, E. A. Brayley
